positivas,negativas,total,pos_periodo,neg_periodo,tot_periodo,tempo_id,servico_id
2688,557,3245,2688,557,3245,1,1
9,1,10,9,1,10,1,2
8,3,11,8,3,11,1,3
85,30,115,85,30,115,1,4
94,47,141,94,47,141,1,5
20,20,40,20,20,40,1,6
24,13,37,24,13,37,1,7
120,34,154,120,34,154,1,8
18,3,21,18,3,21,1,9
15,3,18,15,3,18,1,10
673,360,1033,673,360,1033,1,11
205,102,307,205,102,307,1,12
1279,1354,2633,1279,1354,2633,1,13
2005,1149,3154,2005,1149,3154,1,14
5201,5651,10852,5201,5651,10852,1,15
2623,1410,4033,2623,1410,4033,1,16
5990,4294,10284,5990,4294,10284,1,17
2850,1550,4400,2850,1550,4400,1,18
1897,1162,3059,1897,1162,3059,1,19
48488,30930,79418,48488,30930,79418,1,20
23694,12140,35834,23694,12140,35834,1,21
24796,12415,37211,24796,12415,37211,1,22
850,1170,2020,850,1170,2020,1,23
970,203,1173,970,203,1173,1,24
27,14,41,27,14,41,1,25
18,9,27,18,9,27,1,26
441,898,1339,441,898,1339,1,27
37,10,47,37,10,47,1,28
38,49,87,38,49,87,1,29
45,39,84,45,39,84,1,30
303,200,503,303,200,503,1,31
8,4,12,8,4,12,1,32
13,3,16,13,3,16,1,33
17,13,30,17,13,30,1,34
152,371,523,152,371,523,1,35
98,47,145,98,47,145,1,36
2887,1164,4051,2887,1164,4051,1,37
23,6,29,23,6,29,1,38
486,302,788,486,302,788,1,39
337,113,450,337,113,450,1,40
38,10,48,38,10,48,1,41
1550,1794,3344,1550,1794,3344,1,42
15,0,15,15,0,15,1,43
5,1,6,5,1,6,1,44
44,19,63,44,19,63,1,45
114,46,160,114,46,160,1,46
15,11,26,15,11,26,1,47
18609,9009,27618,18609,9009,27618,1,48
1203,869,2072,1203,869,2072,1,49
7,9,16,7,9,16,1,50
15,19,34,15,19,34,1,51
63,42,105,63,42,105,1,52
197,78,275,197,78,275,1,53
239,198,437,239,198,437,1,54
75,138,213,75,138,213,1,55
114,143,257,114,143,257,1,56
237,412,649,237,412,649,1,57
483,237,720,483,237,720,1,58
690,249,939,690,249,939,1,59
275,231,506,275,231,506,1,60
586,505,1091,586,505,1091,1,61
440,254,694,440,254,694,1,62
162,53,215,162,53,215,1,63
15,6,21,15,6,21,1,64
15,13,28,15,13,28,1,65
261,243,504,261,243,504,1,66
5069,3273,8342,5069,3273,8342,1,67
6345,9929,16274,6345,9929,16274,1,68
23,5,28,23,5,28,1,69
5,2,7,5,2,7,1,70
40,5,45,40,5,45,1,71
1,6,7,1,6,7,1,72
566,949,1515,566,949,1515,1,73
22,3,25,22,3,25,1,74
129,158,287,129,158,287,1,75
71,298,369,71,298,369,1,76
311,198,509,311,198,509,1,77
109,241,350,109,241,350,1,78
36,53,89,36,53,89,1,79
6,2,8,6,2,8,1,80
51,10,61,51,10,61,1,81
2,1,3,2,1,3,1,82
9,2,11,9,2,11,1,83
5,3,8,5,3,8,1,84
1,3,4,1,3,4,1,85
0,0,0,0,0,0,1,86
4,2,6,4,2,6,1,87
5,6,11,5,6,11,1,88
57,43,100,57,43,100,1,89
59,25,84,59,25,84,1,90
79,41,120,79,41,120,1,91
30,14,44,30,14,44,1,92
8,2,10,8,2,10,1,93
56,49,105,56,49,105,1,94
14,9,23,14,9,23,1,95
23,30,53,23,30,53,1,96
4,3,7,4,3,7,1,97
7,1,8,7,1,8,1,98
0,3,3,0,3,3,1,99
126904,40639,167543,126904,40639,167543,1,100
224,29,253,224,29,253,1,101
26,9,35,26,9,35,1,102
4,3,7,4,3,7,1,103
14,3,17,14,3,17,1,104
52,9,61,52,9,61,1,105
499,314,813,499,314,813,1,106
103,80,183,103,80,183,1,107
174,52,226,174,52,226,1,108
140,83,223,140,83,223,1,109
227,382,609,227,382,609,1,110
2,4,6,2,4,6,1,111
68,15,83,68,15,83,1,112
78,88,166,78,88,166,1,113
36,40,76,36,40,76,1,114
53,15,68,53,15,68,1,115
13,14,27,13,14,27,1,116
4,1,5,4,1,5,1,117
39,17,56,39,17,56,1,118
3,1,4,3,1,4,1,119
1,2,3,1,2,3,1,120
3,3,6,3,3,6,1,121
3,5,8,3,5,8,1,122
1641,402,2043,1641,402,2043,1,123
788,1093,1881,788,1093,1881,1,124
15,19,34,15,19,34,1,125
460,1007,1467,460,1007,1467,1,126
68,56,124,68,56,124,1,127
542,768,1310,542,768,1310,1,128
12,4,16,12,4,16,1,129
13,5,18,13,5,18,1,130
112,70,182,112,70,182,1,131
15,16,31,15,16,31,1,132
93,54,147,93,54,147,1,133
24280,24987,49267,24280,24987,49267,1,134
85,63,148,85,63,148,1,135
333,150,483,333,150,483,1,136
12,9,21,12,9,21,1,137
5,8,13,5,8,13,1,138
325,99,424,325,99,424,1,139
59,71,130,59,71,130,1,140
31,5,36,31,5,36,1,141
10,39,49,10,39,49,1,142
125,23,148,125,23,148,1,143
33,6,39,33,6,39,1,144
111,72,183,111,72,183,1,145
176,145,321,176,145,321,1,146
24781,25057,49838,24781,25057,49838,1,147
23,22,45,23,22,45,1,148
27,60,87,27,60,87,1,149
14,14,28,14,14,28,1,150
53,13,66,53,13,66,1,151
261,156,417,261,156,417,1,152
27,6,33,27,6,33,1,153
61,35,96,61,35,96,1,154
6,3,9,6,3,9,1,155
55,1,56,55,1,56,1,156
36,73,109,36,73,109,1,157
1005,728,1733,1005,728,1733,1,158
27,4,31,27,4,31,1,159
56,10,66,56,10,66,1,160
359,521,880,359,521,880,1,161
49,13,62,49,13,62,1,162
3,6,9,3,6,9,1,163
6,1,7,6,1,7,1,164
6,9,15,6,9,15,1,165
2,5,7,2,5,7,1,166
15,6,21,15,6,21,1,167
7,6,13,7,6,13,1,168
141,229,370,141,229,370,1,169
17,23,40,17,23,40,1,170
42,145,187,42,145,187,1,171
13,6,19,13,6,19,1,172
25,4,29,25,4,29,1,173
21,8,29,21,8,29,1,174
114,165,279,114,165,279,1,175
41,18,59,41,18,59,1,176
98,47,145,98,47,145,1,177
10,34,44,10,34,44,1,178
31,35,66,31,35,66,1,179
505,1060,1565,505,1060,1565,1,180
110,169,279,110,169,279,1,181
161,175,336,161,175,336,1,182
13,6,19,13,6,19,1,183
1173,4503,5676,1173,4503,5676,1,184
38,152,190,38,152,190,1,185
312,37,349,312,37,349,1,186
285,22,307,285,22,307,1,187
64,108,172,64,108,172,1,188
92,36,128,92,36,128,1,189
63,33,96,63,33,96,1,190
14,9,23,14,9,23,1,191
140,49,189,140,49,189,1,192
911,1659,2570,911,1659,2570,1,193
31,9,40,31,9,40,1,194
15,5,20,15,5,20,1,195
41,6,47,41,6,47,1,196
8,2,10,8,2,10,1,197
16,6,22,16,6,22,1,198
22,12,34,22,12,34,1,199
73,19,92,73,19,92,1,200
12463,13665,26128,12463,13665,26128,1,201
16,6,22,16,6,22,1,202
42,13,55,42,13,55,1,203
9,0,9,9,0,9,1,204
398,369,767,398,369,767,1,205
38,65,103,38,65,103,1,206
32,12,44,32,12,44,1,207
3359,768,4127,3359,768,4127,1,208
14,3,17,14,3,17,1,209
3,0,3,3,0,3,1,210
43,17,60,43,17,60,1,211
52,55,107,52,55,107,1,212
21,5,26,21,5,26,1,213
38,12,50,38,12,50,1,214
8,15,23,8,15,23,1,215
12,7,19,12,7,19,1,216
13,7,20,13,7,20,1,217
10,5,15,10,5,15,1,218
17,0,17,17,0,17,1,219
10,8,18,10,8,18,1,220
60,241,301,60,241,301,1,221
82,40,122,82,40,122,1,222
423,126,549,423,126,549,1,223
187,78,265,187,78,265,1,224
9,3,12,9,3,12,1,225
9,1,10,9,1,10,1,226
10,9,19,10,9,19,1,227
202,34,236,202,34,236,1,228
548,23,571,548,23,571,1,229
154,27,181,154,27,181,1,230
175,15,190,175,15,190,1,231
9,0,9,9,0,9,1,232
103,79,182,103,79,182,1,233
13,5,18,13,5,18,1,234
39,16,55,39,16,55,1,235
157,882,1039,157,882,1039,1,236
284,311,595,284,311,595,1,237
44,340,384,44,340,384,1,238
29,118,147,29,118,147,1,239
23,118,141,23,118,141,1,240
54,30,84,54,30,84,1,241
106,134,240,106,134,240,1,242
4,3,7,4,3,7,1,243
53,13,66,53,13,66,1,244
35,31,66,35,31,66,1,245
5,4,9,5,4,9,1,246
3,0,3,3,0,3,1,247
24,5,29,24,5,29,1,248
4,3,7,4,3,7,1,249
8,15,23,8,15,23,1,250
6,4,10,6,4,10,1,251
14,13,27,14,13,27,1,252
5,9,14,5,9,14,1,253
2,14,16,2,14,16,1,254
4,1,5,4,1,5,1,255
2,1,3,2,1,3,1,256
5,0,5,5,0,5,1,257
3,3,6,3,3,6,1,258
1,0,1,1,0,1,1,259
1,2,3,1,2,3,1,260
1,1,2,1,1,2,1,261
17,18,35,17,18,35,1,262
214,173,387,214,173,387,1,263
33,15,48,33,15,48,1,264
84,45,129,84,45,129,1,265
21,27,48,21,27,48,1,266
18,4,22,18,4,22,1,267
3,4,7,3,4,7,1,268
1,2,3,1,2,3,1,269
5,0,5,5,0,5,1,270
4,3,7,4,3,7,1,271
44,10,54,44,10,54,1,272
5,5,10,5,5,10,1,273
27,7,34,27,7,34,1,274
4,0,4,4,0,4,1,275
1,1,2,1,1,2,1,276
4,0,4,4,0,4,1,277
2,0,2,2,0,2,1,278
5,0,5,5,0,5,1,279
238,69,307,238,69,307,1,280
19,10,29,19,10,29,1,281
52,52,104,52,52,104,1,282
164,205,369,164,205,369,1,283
48,134,182,48,134,182,1,284
30,16,46,30,16,46,1,285
21,11,32,21,11,32,1,286
5,10,15,5,10,15,1,287
35,34,69,35,34,69,1,288
6,9,15,6,9,15,1,289
1124,356,1480,1124,356,1480,1,290
14,6,20,14,6,20,1,291
13,3,16,13,3,16,1,292
148,47,195,148,47,195,1,293
8,7,15,8,7,15,1,294
54,20,74,54,20,74,1,295
13,9,22,13,9,22,1,296
25,25,50,25,25,50,1,297
11,14,25,11,14,25,1,298
5,5,10,5,5,10,1,299
8,16,24,8,16,24,1,300
8,9,17,8,9,17,1,301
15,13,28,15,13,28,1,302
2,13,15,2,13,15,1,303
3,10,13,3,10,13,1,304
15,12,27,15,12,27,1,305
20,13,33,20,13,33,1,306
11,17,28,11,17,28,1,307
31,43,74,31,43,74,1,308
4,5,9,4,5,9,1,309
1,7,8,1,7,8,1,310
23,15,38,23,15,38,1,311
65,30,95,65,30,95,1,312
14,10,24,14,10,24,1,313
9,4,13,9,4,13,1,314
26,39,65,26,39,65,1,315
4,14,18,4,14,18,1,316
396,224,620,396,224,620,1,317
136,238,374,136,238,374,1,318
6,19,25,6,19,25,1,319
10,89,99,10,89,99,1,320
38,30,68,38,30,68,1,321
26,20,46,26,20,46,1,322
22,10,32,22,10,32,1,323
11,13,24,11,13,24,1,324
12,6,18,12,6,18,1,325
6,29,35,6,29,35,1,326
27,87,114,27,87,114,1,327
103,73,176,103,73,176,1,328
9,3,12,9,3,12,1,329
33,52,85,33,52,85,1,330
13,48,61,13,48,61,1,331
11,20,31,11,20,31,1,332
14,5,19,14,5,19,1,333
17,4,21,17,4,21,1,334
133,142,275,133,142,275,1,335
7,5,12,7,5,12,1,336
1,7,8,1,7,8,1,337
10,4,14,10,4,14,1,338
4,1,5,4,1,5,1,339
34,46,80,34,46,80,1,340
42,72,114,42,72,114,1,341
9,3,12,9,3,12,1,342
1,0,1,1,0,1,1,343
9,5,14,9,5,14,1,344
17,23,40,17,23,40,1,345
31,12,43,31,12,43,1,346
10,10,20,10,10,20,1,347
5,8,13,5,8,13,1,348
14,30,44,14,30,44,1,349
1,0,1,1,0,1,1,350
1,1,2,1,1,2,1,351
0,0,0,0,0,0,1,352
1,3,4,1,3,4,1,353
0,0,0,0,0,0,1,354
6,7,13,6,7,13,1,355
7,0,7,7,0,7,1,356
0,0,0,0,0,0,1,357
0,0,0,0,0,0,1,358
5,4,9,5,4,9,1,359
2,1,3,2,1,3,1,360
1,1,2,1,1,2,1,361
3,1,4,3,1,4,1,362
25,71,96,25,71,96,1,363
42,74,116,42,74,116,1,364
8,8,16,8,8,16,1,365
13,13,26,13,13,26,1,366
19,61,80,19,61,80,1,367
1,8,9,1,8,9,1,368
10,3,13,10,3,13,1,369
2,2,4,2,2,4,1,370
1,0,1,1,0,1,1,371
5,0,5,5,0,5,1,372
17,65,82,17,65,82,1,373
18,3,21,18,3,21,1,374
22,9,31,22,9,31,1,375
1,6,7,1,6,7,1,376
1,1,2,1,1,2,1,377
4,4,8,4,4,8,1,378
529,9,538,529,9,538,1,379
6,2,8,6,2,8,1,380
2,1,3,2,1,3,1,381
24,5,29,24,5,29,1,382
51,16,67,51,16,67,1,383
21,6,27,21,6,27,1,384
4,2,6,4,2,6,1,385
3,0,3,3,0,3,1,386
21,7,28,21,7,28,1,387
12,11,23,12,11,23,1,388
23,27,50,23,27,50,1,389
195,50,245,195,50,245,1,390
72,54,126,72,54,126,1,391
92,32,124,92,32,124,1,392
12,7,19,12,7,19,1,393
10,24,34,10,24,34,1,394
4,6,10,4,6,10,1,395
13,3,16,13,3,16,1,396
3,0,3,3,0,3,1,397
12,5,17,12,5,17,1,398
5,27,32,5,27,32,1,399
5,7,12,5,7,12,1,400
1,0,1,1,0,1,1,401
4,1,5,4,1,5,1,402
1,7,8,1,7,8,1,403
0,0,0,0,0,0,1,404
2,0,2,2,0,2,1,405
0,1,1,0,1,1,1,406
17,24,41,17,24,41,1,407
2,1,3,2,1,3,1,408
5,12,17,5,12,17,1,409
36,19,55,36,19,55,1,410
4,16,20,4,16,20,1,411
6,4,10,6,4,10,1,412
16,12,28,16,12,28,1,413
41,39,80,41,39,80,1,414
33,90,123,33,90,123,1,415
1,2,3,1,2,3,1,416
2,5,7,2,5,7,1,417
125,53,178,125,53,178,1,418
52,41,93,52,41,93,1,419
98,37,135,98,37,135,1,420
6,1,7,6,1,7,1,421
0,1,1,0,1,1,1,422
3,2,5,3,2,5,1,423
6,8,14,6,8,14,1,424
0,2,2,0,2,2,1,425
2,0,2,2,0,2,1,426
8,16,24,8,16,24,1,427
6,0,6,6,0,6,1,428
81,172,253,81,172,253,1,429
23,64,87,23,64,87,1,430
3,19,22,3,19,22,1,431
17,17,34,17,17,34,1,432
18,84,102,18,84,102,1,433
13,4,17,13,4,17,1,434
21,3,24,21,3,24,1,435
8,3,11,8,3,11,1,436
8,0,8,8,0,8,1,437
0,0,0,0,0,0,1,438
5,15,20,5,15,20,1,439
16,10,26,16,10,26,1,440
6,0,6,6,0,6,1,441
7,13,20,7,13,20,1,442
10,10,20,10,10,20,1,443
2,4,6,2,4,6,1,444
13,3,16,13,3,16,1,445
32,4,36,32,4,36,1,446
1356,569,1925,1356,569,1925,1,447
500,177,677,500,177,677,1,448
438,165,603,438,165,603,1,449
345,72,417,345,72,417,1,450
96,481,577,96,481,577,1,451
9,32,41,9,32,41,1,452
597,63,660,597,63,660,1,453
62,31,93,62,31,93,1,454
3,7,10,3,7,10,1,455
13,0,13,13,0,13,1,456
489,81,570,489,81,570,1,457
12,5,17,12,5,17,1,458
4,2,6,4,2,6,1,459
1,1,2,1,1,2,1,460
7,5,12,7,5,12,1,461
8,1,9,8,1,9,1,462
20,6,26,20,6,26,1,463
4,1,5,4,1,5,1,464
28,4,32,28,4,32,1,465
53,52,105,53,52,105,1,466
873,4687,5560,873,4687,5560,1,467
9,63,72,9,63,72,1,468
43,55,98,43,55,98,1,469
98,10,108,98,10,108,1,470
6,6,12,6,6,12,1,471
11,2,13,11,2,13,1,472
6,1,7,6,1,7,1,473
17,9,26,17,9,26,1,474
20,8,28,20,8,28,1,475
2,0,2,2,0,2,1,476
0,2,2,0,2,2,1,477
13,2,15,13,2,15,1,478
32,22,54,32,22,54,1,479
11,5,16,11,5,16,1,480
465,293,758,465,293,758,1,481
12,4,16,12,4,16,1,482
6,3,9,6,3,9,1,483
25,6,31,25,6,31,1,484
20,1,21,20,1,21,1,485
1,2,3,1,2,3,1,486
42,16,58,42,16,58,1,487
166,195,361,166,195,361,1,488
2,2,4,2,2,4,1,489
3,3,6,3,3,6,1,490
2,0,2,2,0,2,1,491
7,9,16,7,9,16,1,492
3,5,8,3,5,8,1,493
167,402,569,167,402,569,1,494
183,476,659,183,476,659,1,495
3,2,5,3,2,5,1,496
4,4,8,4,4,8,1,497
15,30,45,15,30,45,1,498
63,91,154,63,91,154,1,499
33,27,60,33,27,60,1,500
4,0,4,4,0,4,1,501
12,8,20,12,8,20,1,502
10,6,16,10,6,16,1,503
0,2,2,0,2,2,1,504
5,1,6,5,1,6,1,505
3,0,3,3,0,3,1,506
9,2,11,9,2,11,1,507
5,2,7,5,2,7,1,508
11,9,20,11,9,20,1,509
14,4,18,14,4,18,1,510
16,3,19,16,3,19,1,511
365,831,1196,365,831,1196,1,512
114,431,545,114,431,545,1,513
11,11,22,11,11,22,1,514
5,0,5,5,0,5,1,515
1306,156,1462,1306,156,1462,1,516
48,30,78,48,30,78,1,517
12,4,16,12,4,16,1,518
6,0,6,6,0,6,1,519
10,1,11,10,1,11,1,520
16,4,20,16,4,20,1,521
13,2,15,13,2,15,1,522
37,35,72,37,35,72,1,523
23,17,40,23,17,40,1,524
55,9,64,55,9,64,1,525
31,1,32,31,1,32,1,526
25,11,36,25,11,36,1,527
49712,46620,96332,49712,46620,96332,1,528
392,782,1174,392,782,1174,1,529
1536,3102,4638,1536,3102,4638,1,530
300,705,1005,300,705,1005,1,531
22662,51546,74208,22662,51546,74208,1,532
5088,16060,21148,5088,16060,21148,1,533
15723,42054,57777,15723,42054,57777,1,534
3626,6684,10310,3626,6684,10310,1,535
5758,13496,19254,5758,13496,19254,1,536
3713,10561,14274,3713,10561,14274,1,537
101,168,269,101,168,269,1,538
95,86,181,95,86,181,1,539
950,931,1881,950,931,1881,1,540
402,496,898,402,496,898,1,541
1392,862,2254,1392,862,2254,1,542
915,606,1521,915,606,1521,1,543
870,487,1357,870,487,1357,1,544
65,51,116,65,51,116,1,545
451,590,1041,451,590,1041,1,546
232,283,515,232,283,515,1,547
2468,2821,5289,2468,2821,5289,1,548
5,5,10,5,5,10,1,549
8,3,11,8,3,11,1,550
10,3,13,10,3,13,1,551
5,2,7,5,2,7,1,552
9,2,11,9,2,11,1,553
33,8,41,33,8,41,1,554
11,0,11,11,0,11,1,555
24,2,26,24,2,26,1,556
2,0,2,2,0,2,1,557
158,19,177,158,19,177,1,558
2,2,4,2,2,4,1,559
3,3,6,3,3,6,1,560
17,2,19,17,2,19,1,561
2,4,6,2,4,6,1,562
2,1,3,2,1,3,1,563
7,2,9,7,2,9,1,564
4,4,8,4,4,8,1,565
12,3,15,12,3,15,1,566
5,2,7,5,2,7,1,567
4,2,6,4,2,6,1,568
12,3,15,12,3,15,1,569
27,34,61,27,34,61,1,570
0,0,0,0,0,0,1,571
3,12,15,3,12,15,1,572
0,0,0,0,0,0,1,573
1,0,1,1,0,1,1,574
34,9,43,34,9,43,1,575
11,3,14,11,3,14,1,576
23,7,30,23,7,30,1,577
5,10,15,5,10,15,1,578
51,103,154,51,103,154,1,579
4,17,21,4,17,21,1,580
4,15,19,4,15,19,1,581
55,20,75,55,20,75,1,582
6,4,10,6,4,10,1,583
6,4,10,6,4,10,1,584
27,10,37,27,10,37,1,585
3,13,16,3,13,16,1,586
9,1,10,9,1,10,1,587
29,23,52,29,23,52,1,588
19,16,35,19,16,35,1,589
18,50,68,18,50,68,1,590
14,22,36,14,22,36,1,591
6621,5077,11698,6621,5077,11698,1,592
39,38,77,39,38,77,1,593
31,18,49,31,18,49,1,594
31,97,128,31,97,128,1,595
2,5,7,2,5,7,1,596
6,4,10,6,4,10,1,597
3,1,4,3,1,4,1,598
0,2,2,0,2,2,1,599
123,53,176,123,53,176,1,600
16,4,20,16,4,20,1,601
36,31,67,36,31,67,1,602
23,7,30,23,7,30,1,603
110,15,125,110,15,125,1,604
79,20,99,79,20,99,1,605
7,2,9,7,2,9,1,606
41,14,55,41,14,55,1,607
23,13,36,23,13,36,1,608
15,1,16,15,1,16,1,609
88,6,94,88,6,94,1,610
30,7,37,30,7,37,1,611
0,2,2,0,2,2,1,612
330,132,462,330,132,462,1,613
3,2,5,3,2,5,1,614
4,0,4,4,0,4,1,615
2,0,2,2,0,2,1,616
4,9,13,4,9,13,1,617
4,0,4,4,0,4,1,618
1,0,1,1,0,1,1,619
5,1,6,5,1,6,1,620
3,3,6,3,3,6,1,621
11,5,16,11,5,16,1,622
5,5,10,5,5,10,1,623
1,0,1,1,0,1,1,624
10,29,39,10,29,39,1,625
1,0,1,1,0,1,1,626
2,0,2,2,0,2,1,627
3,1,4,3,1,4,1,628
1,3,4,1,3,4,1,629
7,3,10,7,3,10,1,630
5,6,11,5,6,11,1,631
28,19,47,28,19,47,1,632
0,2,2,0,2,2,1,633
2,0,2,2,0,2,1,634
323,41,364,323,41,364,1,635
1,2,3,1,2,3,1,636
3,4,7,3,4,7,1,637
7,6,13,7,6,13,1,638
5,0,5,5,0,5,1,639
9,5,14,9,5,14,1,640
5,7,12,5,7,12,1,641
4,0,4,4,0,4,1,642
2,1,3,2,1,3,1,643
2,0,2,2,0,2,1,644
5,1,6,5,1,6,1,645
1,2,3,1,2,3,1,646
3,0,3,3,0,3,1,647
0,0,0,0,0,0,1,648
5,3,8,5,3,8,1,649
30,23,53,30,23,53,1,650
845,370,1215,845,370,1215,1,651
6702,785,7487,6702,785,7487,1,652
481,530,1011,481,530,1011,1,653
504,509,1013,504,509,1013,1,654
20,4,24,20,4,24,1,655
85,44,129,85,44,129,1,656
5,4,9,5,4,9,1,657
5,3,8,5,3,8,1,658
55,94,149,55,94,149,1,659
1125,4362,5487,1125,4362,5487,1,660
8,0,8,8,0,8,1,661
7,3,10,7,3,10,1,662
8,7,15,8,7,15,1,663
1,2,3,1,2,3,1,664
6,3,9,6,3,9,1,665
43,28,71,43,28,71,1,666
35,45,80,35,45,80,1,667
5,3,8,5,3,8,1,668
11,13,24,11,13,24,1,669
10,2,12,10,2,12,1,670
15,19,34,15,19,34,1,671
2,2,4,2,2,4,1,672
2,9,11,2,9,11,1,673
3,9,12,3,9,12,1,674
11,6,17,11,6,17,1,675
2,2,4,2,2,4,1,676
3,15,18,3,15,18,1,677
3,5,8,3,5,8,1,678
2,3,5,2,3,5,1,679
3,2,5,3,2,5,1,680
39,84,123,39,84,123,1,681
3,8,11,3,8,11,1,682
1,2,3,1,2,3,1,683
56,52,108,56,52,108,1,684
33,40,73,33,40,73,1,685
291,145,436,291,145,436,1,686
20,51,71,20,51,71,1,687
39,109,148,39,109,148,1,688
5,8,13,5,8,13,1,689
7,12,19,7,12,19,1,690
19,23,42,19,23,42,1,691
13,44,57,13,44,57,1,692
36,126,162,36,126,162,1,693
13,14,27,13,14,27,1,694
32,10,42,32,10,42,1,695
17,24,41,17,24,41,1,696
1,3,4,1,3,4,1,697
72,276,348,72,276,348,1,698
35,42,77,35,42,77,1,699
10,10,20,10,10,20,1,700
8,2,10,8,2,10,1,701
4,5,9,4,5,9,1,702
2,3,5,2,3,5,1,703
9,7,16,9,7,16,1,704
1,7,8,1,7,8,1,705
7,10,17,7,10,17,1,706
10,14,24,10,14,24,1,707
10,2,12,10,2,12,1,708
1,15,16,1,15,16,1,709
4,15,19,4,15,19,1,710
8,1,9,8,1,9,1,711
4,0,4,4,0,4,1,712
58,263,321,58,263,321,1,713
28,30,58,28,30,58,1,714
57,78,135,57,78,135,1,715
54,109,163,54,109,163,1,716
37,65,102,37,65,102,1,717
13,5,18,13,5,18,1,718
18,22,40,18,22,40,1,719
47,31,78,47,31,78,1,720
2,7,9,2,7,9,1,721
28,205,233,28,205,233,1,722
16,84,100,16,84,100,1,723
11,15,26,11,15,26,1,724
4,8,12,4,8,12,1,725
5,3,8,5,3,8,1,726
4,3,7,4,3,7,1,727
0,3,3,0,3,3,1,728
2,5,7,2,5,7,1,729
3,5,8,3,5,8,1,730
1,4,5,1,4,5,1,731
2,3,5,2,3,5,1,732
2,5,7,2,5,7,1,733
1,4,5,1,4,5,1,734
5,7,12,5,7,12,1,735
4,2,6,4,2,6,1,736
0,0,0,0,0,0,1,737
2,2,4,2,2,4,1,738
7,1,8,7,1,8,1,739
2,0,2,2,0,2,1,740
8,33,41,8,33,41,1,741
0,3,3,0,3,3,1,742
11,1,12,11,1,12,1,743
23,10,33,23,10,33,1,744
30,55,85,30,55,85,1,745
2,11,13,2,11,13,1,746
4,1,5,4,1,5,1,747
5,7,12,5,7,12,1,748
4,1,5,4,1,5,1,749
2,2,4,2,2,4,1,750
6,1,7,6,1,7,1,751
4,11,15,4,11,15,1,752
49,76,125,49,76,125,1,753
5,7,12,5,7,12,1,754
2,3,5,2,3,5,1,755
2,2,4,2,2,4,1,756
7,5,12,7,5,12,1,757
1,0,1,1,0,1,1,758
1,0,1,1,0,1,1,759
0,0,0,0,0,0,1,760
1,0,1,1,0,1,1,761
0,0,0,0,0,0,1,762
1,1,2,1,1,2,1,763
1,0,1,1,0,1,1,764
0,1,1,0,1,1,1,765
0,0,0,0,0,0,1,766
4,9,13,4,9,13,1,767
7,18,25,7,18,25,1,768
0,4,4,0,4,4,1,769
10,0,10,10,0,10,1,770
1,1,2,1,1,2,1,771
0,1,1,0,1,1,1,772
23,5,28,23,5,28,1,773
1516,388,1904,1516,388,1904,1,774
48,32,80,48,32,80,1,775
62,11,73,62,11,73,1,776
661,766,1427,661,766,1427,1,777
82,758,840,82,758,840,1,778
7,6,13,7,6,13,1,779
9,6,15,9,6,15,1,780
15,36,51,15,36,51,1,781
4,1,5,4,1,5,1,782
5,11,16,5,11,16,1,783
552,972,1524,552,972,1524,1,784
175,56,231,175,56,231,1,785
370,594,964,370,594,964,1,786
20,44,64,20,44,64,1,787
242,880,1122,242,880,1122,1,788
113,206,319,113,206,319,1,789
60,71,131,60,71,131,1,790
131,704,835,131,704,835,1,791
8,1,9,8,1,9,1,792
6,3,9,6,3,9,1,793
7,3,10,7,3,10,1,794
179,40,219,179,40,219,1,795
9,7,16,9,7,16,1,796
5,1,6,5,1,6,1,797
6,0,6,6,0,6,1,798
33,6,39,33,6,39,1,799
3,1,4,3,1,4,1,800
85,15,100,85,15,100,1,801
145,22,167,145,22,167,1,802
130,123,253,130,123,253,1,803
18,8,26,18,8,26,1,804
13,20,33,13,20,33,1,805
16,4,20,16,4,20,1,806
60,74,134,60,74,134,1,807
7,8,15,7,8,15,1,808
7,0,7,7,0,7,1,809
7,4,11,7,4,11,1,810
2,2,4,2,2,4,1,811
1,1,2,1,1,2,1,812
34,16,50,34,16,50,1,813
5,0,5,5,0,5,1,814
49,16,65,49,16,65,1,815
84,4,88,84,4,88,1,816
88,108,196,88,108,196,1,817
330,161,491,330,161,491,1,818
145,96,241,145,96,241,1,819
1776,1177,2953,1776,1177,2953,1,820
33,21,54,33,21,54,1,821
1619,618,2237,1619,618,2237,1,822
30,51,81,30,51,81,1,823
569,232,801,569,232,801,1,824
1023,380,1403,1023,380,1403,1,825
750,585,1335,750,585,1335,1,826
13,4,17,13,4,17,1,827
30,14,44,30,14,44,1,828
7,3,10,7,3,10,1,829
15,20,35,15,20,35,1,830
4,1,5,4,1,5,1,831
36,9,45,36,9,45,1,832
4,4,8,4,4,8,1,833
28,6,34,28,6,34,1,834
4,2,6,4,2,6,1,835
84,110,194,84,110,194,1,836
7,3,10,7,3,10,1,837
20,16,36,20,16,36,1,838
8,3,11,8,3,11,1,839
4,4,8,4,4,8,1,840
36,18,54,36,18,54,1,841
50,49,99,50,49,99,1,842
19,43,62,19,43,62,1,843
2,9,11,2,9,11,1,844
8,5,13,8,5,13,1,845
22,5,27,22,5,27,1,846
2,1,3,2,1,3,1,847
5,1,6,5,1,6,1,848
14,9,23,14,9,23,1,849
249,243,492,249,243,492,1,850
399,357,756,399,357,756,1,851
4,5,9,4,5,9,1,852
34,22,56,34,22,56,1,853
6,18,24,6,18,24,1,854
6,15,21,6,15,21,1,855
13,21,34,13,21,34,1,856
32,8,40,32,8,40,1,857
13,5,18,13,5,18,1,858
9,20,29,9,20,29,1,859
9,3,12,9,3,12,1,860
16,5,21,16,5,21,1,861
48,39,87,48,39,87,1,862
5,42,47,5,42,47,1,863
14,7,21,14,7,21,1,864
18,102,120,18,102,120,1,865
27,11,38,27,11,38,1,866
4,8,12,4,8,12,1,867
8,0,8,8,0,8,1,868
11,3,14,11,3,14,1,869
59,5,64,59,5,64,1,870
1135,186,1321,1135,186,1321,1,871
122,65,187,122,65,187,1,872
49,17,66,49,17,66,1,873
30,20,50,30,20,50,1,874
6,4,10,6,4,10,1,875
159,80,239,159,80,239,1,876
153,66,219,153,66,219,1,877
123,73,196,123,73,196,1,878
11,6,17,11,6,17,1,879
8,9,17,8,9,17,1,880
76,7,83,76,7,83,1,881
8,33,41,8,33,41,1,882
7,7,14,7,7,14,1,883
10,3,13,10,3,13,1,884
3,8,11,3,8,11,1,885
10,5,15,10,5,15,1,886
11,5,16,11,5,16,1,887
14,4,18,14,4,18,1,888
16,20,36,16,20,36,1,889
7,3,10,7,3,10,1,890
21,14,35,21,14,35,1,891
1,0,1,1,0,1,1,892
14,12,26,14,12,26,1,893
7,3,10,7,3,10,1,894
93,34,127,93,34,127,1,895
28,28,56,28,28,56,1,896
5,0,5,5,0,5,1,897
2,0,2,2,0,2,1,898
0,1,1,0,1,1,1,899
1,3,4,1,3,4,1,900
3,3,6,3,3,6,1,901
2,2,4,2,2,4,1,902
12,10,22,12,10,22,1,903
9,13,22,9,13,22,1,904
10,15,25,10,15,25,1,905
23,8,31,23,8,31,1,906
2,4,6,2,4,6,1,907
7,3,10,7,3,10,1,908
4,0,4,4,0,4,1,909
3,3,6,3,3,6,1,910
4,1,5,4,1,5,1,911
3,4,7,3,4,7,1,912
37,8,45,37,8,45,1,913
12,13,25,12,13,25,1,914
4,17,21,4,17,21,1,915
3,4,7,3,4,7,1,916
0,4,4,0,4,4,1,917
2,5,7,2,5,7,1,918
29,120,149,29,120,149,1,919
20,14,34,20,14,34,1,920
17,4,21,17,4,21,1,921
0,0,0,0,0,0,1,922
5,4,9,5,4,9,1,923
2,1,3,2,1,3,1,924
4,9,13,4,9,13,1,925
1,0,1,1,0,1,1,926
0,3,3,0,3,3,1,927
1,3,4,1,3,4,1,928
5,9,14,5,9,14,1,929
4,1,5,4,1,5,1,930
0,1,1,0,1,1,1,931
2,2,4,2,2,4,1,932
0,2,2,0,2,2,1,933
1,2,3,1,2,3,1,934
0,3,3,0,3,3,1,935
0,0,0,0,0,0,1,936
1,2,3,1,2,3,1,937
4,10,14,4,10,14,1,938
0,1,1,0,1,1,1,939
2,4,6,2,4,6,1,940
9,5,14,9,5,14,1,941
2,2,4,2,2,4,1,942
15,25,40,15,25,40,1,943
2,1,3,2,1,3,1,944
24,48,72,24,48,72,1,945
3,4,7,3,4,7,1,946
1,3,4,1,3,4,1,947
41,46,87,41,46,87,1,948
1,1,2,1,1,2,1,949
3,0,3,3,0,3,1,950
2320,901,3221,2320,901,3221,1,951
331,123,454,331,123,454,1,952
2,0,2,2,0,2,1,953
8,2,10,8,2,10,1,954
11,5,16,11,5,16,1,955
47,20,67,47,20,67,1,956
38,99,137,38,99,137,1,957
1,1,2,1,1,2,1,958
276,540,816,276,540,816,1,959
5,1,6,5,1,6,1,960
2,4,6,2,4,6,1,961
4,1,5,4,1,5,1,962
14,5,19,14,5,19,1,963
13,3,16,13,3,16,1,964
2,0,2,2,0,2,1,965
5,4,9,5,4,9,1,966
6,4,10,6,4,10,1,967
5,4,9,5,4,9,1,968
1,2,3,1,2,3,1,969
3,0,3,3,0,3,1,970
6,1,7,6,1,7,1,971
2,1,3,2,1,3,1,972
25,12,37,25,12,37,1,973
2,6,8,2,6,8,1,974
16,5,21,16,5,21,1,975
10,3,13,10,3,13,1,976
9,6,15,9,6,15,1,977
15,20,35,15,20,35,1,978
55,16,71,55,16,71,1,979
20,5,25,20,5,25,1,980
3,5,8,3,5,8,1,981
6,1,7,6,1,7,1,982
7,10,17,7,10,17,1,983
288,40,328,288,40,328,1,984
12,2,14,12,2,14,1,985
33,11,44,33,11,44,1,986
22,7,29,22,7,29,1,987
25,11,36,25,11,36,1,988
7,4,11,7,4,11,1,989
2,1,3,2,1,3,1,990
16,7,23,16,7,23,1,991
9,0,9,9,0,9,1,992
5,1,6,5,1,6,1,993
7,3,10,7,3,10,1,994
5,2,7,5,2,7,1,995
1286,1486,2772,1286,1486,2772,1,996
9,14,23,9,14,23,1,997
44,73,117,44,73,117,1,998
22,38,60,22,38,60,1,999
11,14,25,11,14,25,1,1000
1,4,5,1,4,5,1,1001
6,5,11,6,5,11,1,1002
15,3,18,15,3,18,1,1003
4,4,8,4,4,8,1,1004
0,0,0,0,0,0,1,1005
782,460,1242,782,460,1242,1,1006
68,194,262,68,194,262,1,1007
5,1,6,5,1,6,1,1008
6,5,11,6,5,11,1,1009
5,2,7,5,2,7,1,1010
6,1,7,6,1,7,1,1011
18,6,24,18,6,24,1,1012
5,10,15,5,10,15,1,1013
1,7,8,1,7,8,1,1014
3,1,4,3,1,4,1,1015
33,37,70,33,37,70,1,1016
0,0,0,0,0,0,1,1017
2,0,2,2,0,2,1,1018
1,3,4,1,3,4,1,1019
2,0,2,2,0,2,1,1020
1,0,1,1,0,1,1,1021
0,0,0,0,0,0,1,1022
1,1,2,1,1,2,1,1023
1,0,1,1,0,1,1,1024
0,2,2,0,2,2,1,1025
0,1,1,0,1,1,1,1026
145,198,343,145,198,343,1,1027
4,9,13,4,9,13,1,1028
0,1,1,0,1,1,1,1029
3,0,3,3,0,3,1,1030
5,1,6,5,1,6,1,1031
5,0,5,5,0,5,1,1032
3,6,9,3,6,9,1,1033
1,1,2,1,1,2,1,1034
2,2,4,2,2,4,1,1035
0,1,1,0,1,1,1,1036
2,0,2,2,0,2,1,1037
12,1,13,12,1,13,1,1038
3,7,10,3,7,10,1,1039
33,85,118,33,85,118,1,1040
147,527,674,147,527,674,1,1041
6,1,7,6,1,7,1,1042
8,10,18,8,10,18,1,1043
3,5,8,3,5,8,1,1044
14,6,20,14,6,20,1,1045
7,3,10,7,3,10,1,1046
121,141,262,121,141,262,1,1047
56,273,329,56,273,329,1,1048
55,27,82,55,27,82,1,1049
2,1,3,2,1,3,1,1050
22,17,39,22,17,39,1,1051
164,274,438,164,274,438,1,1052
11,11,22,11,11,22,1,1053
9,14,23,9,14,23,1,1054
15,2,17,15,2,17,1,1055
1,0,1,1,0,1,1,1056
13,7,20,13,7,20,1,1057
221,263,484,221,263,484,1,1058
346,230,576,346,230,576,1,1059
6,2,8,6,2,8,1,1060
58,164,222,58,164,222,1,1061
5,13,18,5,13,18,1,1062
3,16,19,3,16,19,1,1063
1091,1654,2745,1091,1654,2745,1,1064
133,705,838,133,705,838,1,1065
190,638,828,190,638,828,1,1066
67,238,305,67,238,305,1,1067
30,60,90,30,60,90,1,1068
11,10,21,11,10,21,1,1069
38,120,158,38,120,158,1,1070
20,16,36,20,16,36,1,1071
181,234,415,181,234,415,1,1072
2,4,6,2,4,6,1,1073
0,2,2,0,2,2,1,1074
1,2,3,1,2,3,1,1075
7,0,7,7,0,7,1,1076
3,3,6,3,3,6,1,1077
2,23,25,2,23,25,1,1078
8,7,15,8,7,15,1,1079
15,15,30,15,15,30,1,1080
2,4,6,2,4,6,1,1081
23,9,32,23,9,32,1,1082
6,10,16,6,10,16,1,1083
1633,1170,2803,1633,1170,2803,1,1084
17,4,21,17,4,21,1,1085
7,4,11,7,4,11,1,1086
34,22,56,34,22,56,1,1087
7,4,11,7,4,11,1,1088
22,22,44,22,22,44,1,1089
31,74,105,31,74,105,1,1090
0,1,1,0,1,1,1,1091
54,30,84,54,30,84,1,1092
238,96,334,238,96,334,1,1093
80,12,92,80,12,92,1,1094
22,10,32,22,10,32,1,1095
28,10,38,28,10,38,1,1096
36,17,53,36,17,53,1,1097
66,41,107,66,41,107,1,1098
1671,1188,2859,1671,1188,2859,1,1099
13,17,30,13,17,30,1,1100
49,20,69,49,20,69,1,1101
24,3,27,24,3,27,1,1102
56,32,88,56,32,88,1,1103
5,14,19,5,14,19,1,1104
13,6,19,13,6,19,1,1105
13,3,16,13,3,16,1,1106
3,2,5,3,2,5,1,1107
1,1,2,1,1,2,1,1108
4,6,10,4,6,10,1,1109
5,2,7,5,2,7,1,1110
3,0,3,3,0,3,1,1111
21,1,22,21,1,22,1,1112
18,1,19,18,1,19,1,1113
8,5,13,8,5,13,1,1114
7,6,13,7,6,13,1,1115
5,19,24,5,19,24,1,1116
15,8,23,15,8,23,1,1117
15,9,24,15,9,24,1,1118
345,1058,1403,345,1058,1403,1,1119
148,898,1046,148,898,1046,1,1120
69,203,272,69,203,272,1,1121
1346,250,1596,1346,250,1596,1,1122
17,4,21,17,4,21,1,1123
435,1208,1643,435,1208,1643,1,1124
41,79,120,41,79,120,1,1125
4,3,7,4,3,7,1,1126
1,8,9,1,8,9,1,1127
7,23,30,7,23,30,1,1128
0,2,2,0,2,2,1,1129
2,1,3,2,1,3,1,1130
1,2,3,1,2,3,1,1131
2,0,2,2,0,2,1,1132
637,925,1562,637,925,1562,1,1133
2,0,2,2,0,2,1,1134
4,5,9,4,5,9,1,1135
27,42,69,27,42,69,1,1136
164,259,423,164,259,423,1,1137
10,3,13,10,3,13,1,1138
15,0,15,15,0,15,1,1139
7,9,16,7,9,16,1,1140
0,2,2,0,2,2,1,1141
8,11,19,8,11,19,1,1142
8,30,38,8,30,38,1,1143
21,4,25,21,4,25,1,1144
3,5,8,3,5,8,1,1145
3536,2502,6038,3536,2502,6038,1,1146
152,8,160,152,8,160,1,1147
12,6,18,12,6,18,1,1148
41,27,68,41,27,68,1,1149
40,17,57,40,17,57,1,1150
53,187,240,53,187,240,1,1151
223,576,799,223,576,799,1,1152
55,176,231,55,176,231,1,1153
28,10,38,28,10,38,1,1154
12,13,25,12,13,25,1,1155
48,55,103,48,55,103,1,1156
15,10,25,15,10,25,1,1157
11,2,13,11,2,13,1,1158
26,7,33,26,7,33,1,1159
43,37,80,43,37,80,1,1160
42,84,126,42,84,126,1,1161
193,303,496,193,303,496,1,1162
38,88,126,38,88,126,1,1163
39,42,81,39,42,81,1,1164
8,1,9,8,1,9,1,1165
2128,3435,5563,2128,3435,5563,1,1166
288,223,511,288,223,511,1,1167
9,20,29,9,20,29,1,1168
178,149,327,178,149,327,1,1169
11858,5458,17316,11858,5458,17316,1,1170
30,24,54,30,24,54,1,1171
192,55,247,192,55,247,1,1172
28,5,33,28,5,33,1,1173
6,4,10,6,4,10,1,1174
1231,338,1569,1231,338,1569,1,1175
209,160,369,209,160,369,1,1176
273,425,698,273,425,698,1,1177
65,7,72,65,7,72,1,1178
630449,179003,809452,630449,179003,809452,1,1179
253,100,353,253,100,353,1,1180
113,51,164,113,51,164,1,1181
67,32,99,67,32,99,1,1182
639,212,851,639,212,851,1,1183
115,86,201,115,86,201,1,1184
183,159,342,183,159,342,1,1185
76,129,205,76,129,205,1,1186
244,368,612,244,368,612,1,1187
235,342,577,235,342,577,1,1188
208,71,279,208,71,279,1,1189
10,5,15,10,5,15,1,1190
53,16,69,53,16,69,1,1191
1027,1859,2886,1027,1859,2886,1,1192
31,75,106,31,75,106,1,1193
135,844,979,135,844,979,1,1194
989,1256,2245,989,1256,2245,1,1195
310,267,577,310,267,577,1,1196
939,1073,2012,939,1073,2012,1,1197
2493,4919,7412,2493,4919,7412,1,1198
71,120,191,71,120,191,1,1199
104,172,276,104,172,276,1,1200
2123,1568,3691,2123,1568,3691,1,1201
3,4,7,3,4,7,1,1202
8,4,12,8,4,12,1,1203
1,1,2,1,1,2,1,1204
0,0,0,0,0,0,1,1205
1458,1369,2827,1458,1369,2827,1,1206
7,24,31,7,24,31,1,1207
90,30,120,90,30,120,1,1208
129,40,169,129,40,169,1,1209
731,464,1195,731,464,1195,1,1210
47,50,97,47,50,97,1,1211
233,52,285,233,52,285,1,1212
113,14,127,113,14,127,1,1213
1423,1823,3246,1423,1823,3246,1,1214
13,13,26,13,13,26,1,1215
163,65,228,163,65,228,1,1216
14,5,19,14,5,19,1,1217
7,3,10,7,3,10,1,1218
4,1,5,4,1,5,1,1219
2,0,2,2,0,2,1,1220
0,0,0,0,0,0,1,1221
2,3,5,2,3,5,1,1222
0,0,0,0,0,0,1,1223
0,0,0,0,0,0,1,1224
0,0,0,0,0,0,1,1225
1,4,5,1,4,5,1,1226
1,0,1,1,0,1,1,1227
6,5,11,6,5,11,1,1228
6,1,7,6,1,7,1,1229
0,1,1,0,1,1,1,1230
0,0,0,0,0,0,1,1231
0,0,0,0,0,0,1,1232
17,14,31,17,14,31,1,1233
1,1,2,1,1,2,1,1234
0,1,1,0,1,1,1,1235
1,2,3,1,2,3,1,1236
1,0,1,1,0,1,1,1237
18,18,36,18,18,36,1,1238
4,1,5,4,1,5,1,1239
8,6,14,8,6,14,1,1240
7,4,11,7,4,11,1,1241
0,0,0,0,0,0,1,1242
0,1,1,0,1,1,1,1243
2,1,3,2,1,3,1,1244
4,6,10,4,6,10,1,1245
0,0,0,0,0,0,1,1246
1,1,2,1,1,2,1,1247
35,33,68,35,33,68,1,1248
5,0,5,5,0,5,1,1249
2,0,2,2,0,2,1,1250
1,0,1,1,0,1,1,1251
2,1,3,2,1,3,1,1252
4,0,4,4,0,4,1,1253
0,0,0,0,0,0,1,1254
38,46,84,38,46,84,1,1255
1,0,1,1,0,1,1,1256
2,1,3,2,1,3,1,1257
0,0,0,0,0,0,1,1258
1,0,1,1,0,1,1,1259
7,7,14,7,7,14,1,1260
33,12,45,33,12,45,1,1261
1,0,1,1,0,1,1,1262
10,4,14,10,4,14,1,1263
0,0,0,0,0,0,1,1264
1,0,1,1,0,1,1,1265
2,0,2,2,0,2,1,1266
4,3,7,4,3,7,1,1267
6,10,16,6,10,16,1,1268
5,0,5,5,0,5,1,1269
0,0,0,0,0,0,1,1270
5,0,5,5,0,5,1,1271
2,0,2,2,0,2,1,1272
13,12,25,13,12,25,1,1273
1,0,1,1,0,1,1,1274
1,1,2,1,1,2,1,1275
1,2,3,1,2,3,1,1276
4,1,5,4,1,5,1,1277
0,0,0,0,0,0,1,1278
1,1,2,1,1,2,1,1279
1,0,1,1,0,1,1,1280
0,0,0,0,0,0,1,1281
0,5,5,0,5,5,1,1282
7,2,9,7,2,9,1,1283
4,0,4,4,0,4,1,1284
0,1,1,0,1,1,1,1285
0,0,0,0,0,0,1,1286
0,0,0,0,0,0,1,1287
3,1,4,3,1,4,1,1288
3,0,3,3,0,3,1,1289
15,18,33,15,18,33,1,1290
0,2,2,0,2,2,1,1291
2,1,3,2,1,3,1,1292
4,2,6,4,2,6,1,1293
1,0,1,1,0,1,1,1294
2,2,4,2,2,4,1,1295
3,2,5,3,2,5,1,1296
0,0,0,0,0,0,1,1297
3,1,4,3,1,4,1,1298
13,4,17,13,4,17,1,1299
0,0,0,0,0,0,1,1300
0,0,0,0,0,0,1,1301
5,8,13,5,8,13,1,1302
3,3,6,3,3,6,1,1303
3,2,5,3,2,5,1,1304
5,0,5,5,0,5,1,1305
0,0,0,0,0,0,1,1306
2,4,6,2,4,6,1,1307
1,2,3,1,2,3,1,1308
5,4,9,5,4,9,1,1309
3,3,6,3,3,6,1,1310
0,2,2,0,2,2,1,1311
0,8,8,0,8,8,1,1312
1,0,1,1,0,1,1,1313
1,0,1,1,0,1,1,1314
0,0,0,0,0,0,1,1315
1,0,1,1,0,1,1,1316
0,0,0,0,0,0,1,1317
4,4,8,4,4,8,1,1318
6,2,8,6,2,8,1,1319
0,0,0,0,0,0,1,1320
1,0,1,1,0,1,1,1321
0,1,1,0,1,1,1,1322
0,0,0,0,0,0,1,1323
5,0,5,5,0,5,1,1324
0,2,2,0,2,2,1,1325
1,1,2,1,1,2,1,1326
7,0,7,7,0,7,1,1327
8,4,12,8,4,12,1,1328
1,0,1,1,0,1,1,1329
1,0,1,1,0,1,1,1330
4,2,6,4,2,6,1,1331
2,0,2,2,0,2,1,1332
1,0,1,1,0,1,1,1333
2,0,2,2,0,2,1,1334
2,1,3,2,1,3,1,1335
2,1,3,2,1,3,1,1336
4,6,10,4,6,10,1,1337
2,3,5,2,3,5,1,1338
1,1,2,1,1,2,1,1339
3,5,8,3,5,8,1,1340
8,0,8,8,0,8,1,1341
1,0,1,1,0,1,1,1342
0,1,1,0,1,1,1,1343
2,2,4,2,2,4,1,1344
2,0,2,2,0,2,1,1345
0,0,0,0,0,0,1,1346
0,0,0,0,0,0,1,1347
0,3,3,0,3,3,1,1348
1,3,4,1,3,4,1,1349
3,3,6,3,3,6,1,1350
4,5,9,4,5,9,1,1351
0,0,0,0,0,0,1,1352
0,0,0,0,0,0,1,1353
4,2,6,4,2,6,1,1354
0,0,0,0,0,0,1,1355
1,1,2,1,1,2,1,1356
0,1,1,0,1,1,1,1357
1,2,3,1,2,3,1,1358
3,0,3,3,0,3,1,1359
5,1,6,5,1,6,1,1360
22,23,45,22,23,45,1,1361
1,2,3,1,2,3,1,1362
4,4,8,4,4,8,1,1363
1,1,2,1,1,2,1,1364
0,0,0,0,0,0,1,1365
2,1,3,2,1,3,1,1366
2,3,5,2,3,5,1,1367
0,1,1,0,1,1,1,1368
2,1,3,2,1,3,1,1369
0,0,0,0,0,0,1,1370
5,0,5,5,0,5,1,1371
1,0,1,1,0,1,1,1372
2,0,2,2,0,2,1,1373
6,6,12,6,6,12,1,1374
1,1,2,1,1,2,1,1375
1,0,1,1,0,1,1,1376
1,0,1,1,0,1,1,1377
0,0,0,0,0,0,1,1378
0,0,0,0,0,0,1,1379
0,0,0,0,0,0,1,1380
0,0,0,0,0,0,1,1381
4,0,4,4,0,4,1,1382
36,26,62,36,26,62,1,1383
2,2,4,2,2,4,1,1384
4,0,4,4,0,4,1,1385
3,2,5,3,2,5,1,1386
4,0,4,4,0,4,1,1387
2,4,6,2,4,6,1,1388
3,4,7,3,4,7,1,1389
1,0,1,1,0,1,1,1390
5,3,8,5,3,8,1,1391
2,0,2,2,0,2,1,1392
3,1,4,3,1,4,1,1393
1,1,2,1,1,2,1,1394
22,89,111,22,89,111,1,1395
1,0,1,1,0,1,1,1396
2,2,4,2,2,4,1,1397
0,0,0,0,0,0,1,1398
5,5,10,5,5,10,1,1399
1,0,1,1,0,1,1,1400
3,1,4,3,1,4,1,1401
3,0,3,3,0,3,1,1402
10,6,16,10,6,16,1,1403
1,2,3,1,2,3,1,1404
2,6,8,2,6,8,1,1405
4,0,4,4,0,4,1,1406
3,3,6,3,3,6,1,1407
6,0,6,6,0,6,1,1408
1,2,3,1,2,3,1,1409
1,0,1,1,0,1,1,1410
6,1,7,6,1,7,1,1411
6,3,9,6,3,9,1,1412
1,4,5,1,4,5,1,1413
2,6,8,2,6,8,1,1414
3,0,3,3,0,3,1,1415
4,5,9,4,5,9,1,1416
1,0,1,1,0,1,1,1417
5,20,25,5,20,25,1,1418
9,2,11,9,2,11,1,1419
6,4,10,6,4,10,1,1420
3,5,8,3,5,8,1,1421
1,0,1,1,0,1,1,1422
1,2,3,1,2,3,1,1423
22,11,33,22,11,33,1,1424
5,14,19,5,14,19,1,1425
131,159,290,131,159,290,1,1426
1,1,2,1,1,2,1,1427
1,1,2,1,1,2,1,1428
0,0,0,0,0,0,1,1429
4,1,5,4,1,5,1,1430
1,0,1,1,0,1,1,1431
0,0,0,0,0,0,1,1432
1,5,6,1,5,6,1,1433
2,0,2,2,0,2,1,1434
0,1,1,0,1,1,1,1435
5,2,7,5,2,7,1,1436
0,3,3,0,3,3,1,1437
3,2,5,3,2,5,1,1438
3,2,5,3,2,5,1,1439
3,0,3,3,0,3,1,1440
7,0,7,7,0,7,1,1441
2,2,4,2,2,4,1,1442
2,2,4,2,2,4,1,1443
3,0,3,3,0,3,1,1444
2,3,5,2,3,5,1,1445
0,1,1,0,1,1,1,1446
0,2,2,0,2,2,1,1447
0,0,0,0,0,0,1,1448
5,1,6,5,1,6,1,1449
0,0,0,0,0,0,1,1450
3,2,5,3,2,5,1,1451
0,0,0,0,0,0,1,1452
1,0,1,1,0,1,1,1453
3,0,3,3,0,3,1,1454
22,13,35,22,13,35,1,1455
3,3,6,3,3,6,1,1456
2,0,2,2,0,2,1,1457
2,0,2,2,0,2,1,1458
0,2,2,0,2,2,1,1459
1,2,3,1,2,3,1,1460
0,0,0,0,0,0,1,1461
4,1,5,4,1,5,1,1462
23,18,41,23,18,41,1,1463
0,1,1,0,1,1,1,1464
1,1,2,1,1,2,1,1465
3,0,3,3,0,3,1,1466
0,0,0,0,0,0,1,1467
3,0,3,3,0,3,1,1468
3,2,5,3,2,5,1,1469
5,1,6,5,1,6,1,1470
1,0,1,1,0,1,1,1471
2,2,4,2,2,4,1,1472
2,0,2,2,0,2,1,1473
2,4,6,2,4,6,1,1474
2,5,7,2,5,7,1,1475
45,4,49,45,4,49,1,1476
3,1,4,3,1,4,1,1477
2,4,6,2,4,6,1,1478
1,3,4,1,3,4,1,1479
1,0,1,1,0,1,1,1480
1,0,1,1,0,1,1,1481
1,2,3,1,2,3,1,1482
13,14,27,13,14,27,1,1483
9,1,10,9,1,10,1,1484
5,1,6,5,1,6,1,1485
1,3,4,1,3,4,1,1486
156,103,259,156,103,259,1,1487
1,0,1,1,0,1,1,1488
0,0,0,0,0,0,1,1489
3,0,3,3,0,3,1,1490
1,0,1,1,0,1,1,1491
4,1,5,4,1,5,1,1492
4,1,5,4,1,5,1,1493
2,4,6,2,4,6,1,1494
0,0,0,0,0,0,1,1495
9,2,11,9,2,11,1,1496
1,1,2,1,1,2,1,1497
3,0,3,3,0,3,1,1498
2,0,2,2,0,2,1,1499
23,3,26,23,3,26,1,1500
6,0,6,6,0,6,1,1501
4,0,4,4,0,4,1,1502
5,1,6,5,1,6,1,1503
4,0,4,4,0,4,1,1504
9,0,9,9,0,9,1,1505
1,0,1,1,0,1,1,1506
4,1,5,4,1,5,1,1507
11,2,13,11,2,13,1,1508
2,1,3,2,1,3,1,1509
1,0,1,1,0,1,1,1510
0,1,1,0,1,1,1,1511
5,7,12,5,7,12,1,1512
2,5,7,2,5,7,1,1513
2,0,2,2,0,2,1,1514
22,7,29,22,7,29,1,1515
0,0,0,0,0,0,1,1516
17,4,21,17,4,21,1,1517
1,0,1,1,0,1,1,1518
45,22,67,45,22,67,1,1519
2,1,3,2,1,3,1,1520
0,0,0,0,0,0,1,1521
3,5,8,3,5,8,1,1522
2,8,10,2,8,10,1,1523
0,0,0,0,0,0,1,1524
3,0,3,3,0,3,1,1525
2,0,2,2,0,2,1,1526
0,1,1,0,1,1,1,1527
5,8,13,5,8,13,1,1528
3,2,5,3,2,5,1,1529
234,240,474,234,240,474,1,1530
2,1,3,2,1,3,1,1531
5,1,6,5,1,6,1,1532
2,1,3,2,1,3,1,1533
1,0,1,1,0,1,1,1534
0,0,0,0,0,0,1,1535
0,0,0,0,0,0,1,1536
0,1,1,0,1,1,1,1537
2,2,4,2,2,4,1,1538
5,1,6,5,1,6,1,1539
3,2,5,3,2,5,1,1540
0,2,2,0,2,2,1,1541
2,3,5,2,3,5,1,1542
1,1,2,1,1,2,1,1543
1,1,2,1,1,2,1,1544
0,0,0,0,0,0,1,1545
0,1,1,0,1,1,1,1546
3,0,3,3,0,3,1,1547
2,0,2,2,0,2,1,1548
6,1,7,6,1,7,1,1549
25,12,37,25,12,37,1,1550
13,4,17,13,4,17,1,1551
1,0,1,1,0,1,1,1552
3,5,8,3,5,8,1,1553
1,1,2,1,1,2,1,1554
0,0,0,0,0,0,1,1555
3,1,4,3,1,4,1,1556
5,1,6,5,1,6,1,1557
1,0,1,1,0,1,1,1558
1,0,1,1,0,1,1,1559
2,1,3,2,1,3,1,1560
7,0,7,7,0,7,1,1561
2,0,2,2,0,2,1,1562
0,2,2,0,2,2,1,1563
1,0,1,1,0,1,1,1564
1,3,4,1,3,4,1,1565
6,7,13,6,7,13,1,1566
0,0,0,0,0,0,1,1567
6,1,7,6,1,7,1,1568
0,4,4,0,4,4,1,1569
0,2,2,0,2,2,1,1570
4,4,8,4,4,8,1,1571
38,34,72,38,34,72,1,1572
17,12,29,17,12,29,1,1573
7,1,8,7,1,8,1,1574
1,2,3,1,2,3,1,1575
4,4,8,4,4,8,1,1576
0,0,0,0,0,0,1,1577
0,1,1,0,1,1,1,1578
5,1,6,5,1,6,1,1579
0,0,0,0,0,0,1,1580
1,3,4,1,3,4,1,1581
0,2,2,0,2,2,1,1582
2,4,6,2,4,6,1,1583
5,6,11,5,6,11,1,1584
0,0,0,0,0,0,1,1585
1,2,3,1,2,3,1,1586
4,7,11,4,7,11,1,1587
0,1,1,0,1,1,1,1588
1,0,1,1,0,1,1,1589
0,0,0,0,0,0,1,1590
1,0,1,1,0,1,1,1591
1,0,1,1,0,1,1,1592
1,0,1,1,0,1,1,1593
2,5,7,2,5,7,1,1594
1,0,1,1,0,1,1,1595
1,7,8,1,7,8,1,1596
6,1,7,6,1,7,1,1597
2,0,2,2,0,2,1,1598
7,1,8,7,1,8,1,1599
281,87,368,281,87,368,1,1600
19,11,30,19,11,30,1,1601
27,21,48,27,21,48,1,1602
6,0,6,6,0,6,1,1603
1,0,1,1,0,1,1,1604
6,2,8,6,2,8,1,1605
2,0,2,2,0,2,1,1606
8,1,9,8,1,9,1,1607
1,4,5,1,4,5,1,1608
0,0,0,0,0,0,1,1609
2,0,2,2,0,2,1,1610
0,0,0,0,0,0,1,1611
0,0,0,0,0,0,1,1612
1,0,1,1,0,1,1,1613
6,0,6,6,0,6,1,1614
2,0,2,2,0,2,1,1615
0,0,0,0,0,0,1,1616
3,0,3,3,0,3,1,1617
4,13,17,4,13,17,1,1618
3,2,5,3,2,5,1,1619
4,3,7,4,3,7,1,1620
3,1,4,3,1,4,1,1621
1,0,1,1,0,1,1,1622
2,2,4,2,2,4,1,1623
0,0,0,0,0,0,1,1624
2,2,4,2,2,4,1,1625
4,2,6,4,2,6,1,1626
3,0,3,3,0,3,1,1627
1,7,8,1,7,8,1,1628
2,1,3,2,1,3,1,1629
2,3,5,2,3,5,1,1630
2,0,2,2,0,2,1,1631
2,0,2,2,0,2,1,1632
4,0,4,4,0,4,1,1633
3,0,3,3,0,3,1,1634
0,0,0,0,0,0,1,1635
4,3,7,4,3,7,1,1636
2,1,3,2,1,3,1,1637
1,1,2,1,1,2,1,1638
4,1,5,4,1,5,1,1639
4,0,4,4,0,4,1,1640
2,2,4,2,2,4,1,1641
0,2,2,0,2,2,1,1642
2,1,3,2,1,3,1,1643
0,0,0,0,0,0,1,1644
9,5,14,9,5,14,1,1645
0,0,0,0,0,0,1,1646
0,1,1,0,1,1,1,1647
0,0,0,0,0,0,1,1648
4,3,7,4,3,7,1,1649
8,1,9,8,1,9,1,1650
17,7,24,17,7,24,1,1651
7,2,9,7,2,9,1,1652
1,1,2,1,1,2,1,1653
1,0,1,1,0,1,1,1654
1,1,2,1,1,2,1,1655
1,0,1,1,0,1,1,1656
3,2,5,3,2,5,1,1657
0,0,0,0,0,0,1,1658
7,2,9,7,2,9,1,1659
0,2,2,0,2,2,1,1660
0,0,0,0,0,0,1,1661
1,0,1,1,0,1,1,1662
1,2,3,1,2,3,1,1663
2,0,2,2,0,2,1,1664
6,5,11,6,5,11,1,1665
1,0,1,1,0,1,1,1666
0,0,0,0,0,0,1,1667
4,1,5,4,1,5,1,1668
6,2,8,6,2,8,1,1669
6,2,8,6,2,8,1,1670
1,0,1,1,0,1,1,1671
0,0,0,0,0,0,1,1672
5,2,7,5,2,7,1,1673
5,2,7,5,2,7,1,1674
13,4,17,13,4,17,1,1675
1,0,1,1,0,1,1,1676
5,6,11,5,6,11,1,1677
2,0,2,2,0,2,1,1678
8,3,11,8,3,11,1,1679
0,0,0,0,0,0,1,1680
2,2,4,2,2,4,1,1681
1,2,3,1,2,3,1,1682
0,4,4,0,4,4,1,1683
53,84,137,53,84,137,1,1684
15,73,88,15,73,88,1,1685
1,2,3,1,2,3,1,1686
0,2,2,0,2,2,1,1687
61,47,108,61,47,108,1,1688
0,1,1,0,1,1,1,1689
0,1,1,0,1,1,1,1690
2,1,3,2,1,3,1,1691
9,3,12,9,3,12,1,1692
1,2,3,1,2,3,1,1693
1,2,3,1,2,3,1,1694
67,95,162,67,95,162,1,1695
0,0,0,0,0,0,1,1696
1,0,1,1,0,1,1,1697
2,0,2,2,0,2,1,1698
0,2,2,0,2,2,1,1699
7,11,18,7,11,18,1,1700
1,1,2,1,1,2,1,1701
0,4,4,0,4,4,1,1702
1,1,2,1,1,2,1,1703
116,63,179,116,63,179,1,1704
5,4,9,5,4,9,1,1705
3,2,5,3,2,5,1,1706
0,0,0,0,0,0,1,1707
16,15,31,16,15,31,1,1708
3,5,8,3,5,8,1,1709
0,2,2,0,2,2,1,1710
5,2,7,5,2,7,1,1711
2,1,3,2,1,3,1,1712
2,0,2,2,0,2,1,1713
2,0,2,2,0,2,1,1714
2,0,2,2,0,2,1,1715
65,35,100,65,35,100,1,1716
0,0,0,0,0,0,1,1717
0,1,1,0,1,1,1,1718
0,2,2,0,2,2,1,1719
2,0,2,2,0,2,1,1720
2,1,3,2,1,3,1,1721
10,21,31,10,21,31,1,1722
0,0,0,0,0,0,1,1723
4,0,4,4,0,4,1,1724
2,1,3,2,1,3,1,1725
3,1,4,3,1,4,1,1726
6,2,8,6,2,8,1,1727
33,8,41,33,8,41,1,1728
2,3,5,2,3,5,1,1729
0,0,0,0,0,0,1,1730
1,1,2,1,1,2,1,1731
0,0,0,0,0,0,1,1732
1,1,2,1,1,2,1,1733
2,0,2,2,0,2,1,1734
1,0,1,1,0,1,1,1735
2,2,4,2,2,4,1,1736
2,0,2,2,0,2,1,1737
4,3,7,4,3,7,1,1738
2,1,3,2,1,3,1,1739
0,1,1,0,1,1,1,1740
7,2,9,7,2,9,1,1741
6,2,8,6,2,8,1,1742
1,0,1,1,0,1,1,1743
1,0,1,1,0,1,1,1744
0,0,0,0,0,0,1,1745
1,0,1,1,0,1,1,1746
3,0,3,3,0,3,1,1747
0,1,1,0,1,1,1,1748
0,3,3,0,3,3,1,1749
0,0,0,0,0,0,1,1750
2,1,3,2,1,3,1,1751
0,0,0,0,0,0,1,1752
7,7,14,7,7,14,1,1753
108,129,237,108,129,237,1,1754
3,3,6,3,3,6,1,1755
1,1,2,1,1,2,1,1756
0,0,0,0,0,0,1,1757
2,0,2,2,0,2,1,1758
4,6,10,4,6,10,1,1759
3,0,3,3,0,3,1,1760
6,2,8,6,2,8,1,1761
4,0,4,4,0,4,1,1762
1,2,3,1,2,3,1,1763
2,2,4,2,2,4,1,1764
0,1,1,0,1,1,1,1765
2,1,3,2,1,3,1,1766
1,0,1,1,0,1,1,1767
0,1,1,0,1,1,1,1768
0,0,0,0,0,0,1,1769
4,0,4,4,0,4,1,1770
9,11,20,9,11,20,1,1771
3,0,3,3,0,3,1,1772
0,2,2,0,2,2,1,1773
1,1,2,1,1,2,1,1774
11,23,34,11,23,34,1,1775
9,8,17,9,8,17,1,1776
3,1,4,3,1,4,1,1777
0,1,1,0,1,1,1,1778
3,0,3,3,0,3,1,1779
2,0,2,2,0,2,1,1780
1,1,2,1,1,2,1,1781
3,0,3,3,0,3,1,1782
1,0,1,1,0,1,1,1783
5,3,8,5,3,8,1,1784
35,12,47,35,12,47,1,1785
0,2,2,0,2,2,1,1786
7,2,9,7,2,9,1,1787
1,0,1,1,0,1,1,1788
0,1,1,0,1,1,1,1789
3,2,5,3,2,5,1,1790
0,4,4,0,4,4,1,1791
1,1,2,1,1,2,1,1792
0,0,0,0,0,0,1,1793
1,2,3,1,2,3,1,1794
0,0,0,0,0,0,1,1795
143,58,201,143,58,201,1,1796
3,0,3,3,0,3,1,1797
0,0,0,0,0,0,1,1798
21,3,24,21,3,24,1,1799
20,9,29,20,9,29,1,1800
1,3,4,1,3,4,1,1801
1,1,2,1,1,2,1,1802
6,1,7,6,1,7,1,1803
3,2,5,3,2,5,1,1804
15,3,18,15,3,18,1,1805
0,0,0,0,0,0,1,1806
5,4,9,5,4,9,1,1807
9,6,15,9,6,15,1,1808
0,0,0,0,0,0,1,1809
1,0,1,1,0,1,1,1810
0,1,1,0,1,1,1,1811
0,0,0,0,0,0,1,1812
0,2,2,0,2,2,1,1813
6,18,24,6,18,24,1,1814
0,1,1,0,1,1,1,1815
6,7,13,6,7,13,1,1816
1,0,1,1,0,1,1,1817
3,1,4,3,1,4,1,1818
3,5,8,3,5,8,1,1819
1,3,4,1,3,4,1,1820
8,18,26,8,18,26,1,1821
0,4,4,0,4,4,1,1822
75,33,108,75,33,108,1,1823
5,1,6,5,1,6,1,1824
6,1,7,6,1,7,1,1825
8,2,10,8,2,10,1,1826
0,3,3,0,3,3,1,1827
5,1,6,5,1,6,1,1828
0,0,0,0,0,0,1,1829
10,8,18,10,8,18,1,1830
0,1,1,0,1,1,1,1831
1,0,1,1,0,1,1,1832
0,0,0,0,0,0,1,1833
5,2,7,5,2,7,1,1834
2,0,2,2,0,2,1,1835
4,1,5,4,1,5,1,1836
1,0,1,1,0,1,1,1837
2,0,2,2,0,2,1,1838
1,1,2,1,1,2,1,1839
16,12,28,16,12,28,1,1840
5,2,7,5,2,7,1,1841
1,4,5,1,4,5,1,1842
11,7,18,11,7,18,1,1843
0,0,0,0,0,0,1,1844
5,6,11,5,6,11,1,1845
0,0,0,0,0,0,1,1846
0,0,0,0,0,0,1,1847
5,0,5,5,0,5,1,1848
31,12,43,31,12,43,1,1849
0,0,0,0,0,0,1,1850
2,0,2,2,0,2,1,1851
0,0,0,0,0,0,1,1852
3,1,4,3,1,4,1,1853
7,4,11,7,4,11,1,1854
3,2,5,3,2,5,1,1855
4,0,4,4,0,4,1,1856
2,2,4,2,2,4,1,1857
8,4,12,8,4,12,1,1858
0,1,1,0,1,1,1,1859
0,0,0,0,0,0,1,1860
0,0,0,0,0,0,1,1861
1,0,1,1,0,1,1,1862
0,0,0,0,0,0,1,1863
2,0,2,2,0,2,1,1864
4,0,4,4,0,4,1,1865
0,0,0,0,0,0,1,1866
2,2,4,2,2,4,1,1867
3,1,4,3,1,4,1,1868
1,0,1,1,0,1,1,1869
18,34,52,18,34,52,1,1870
0,0,0,0,0,0,1,1871
7,2,9,7,2,9,1,1872
4,0,4,4,0,4,1,1873
2,1,3,2,1,3,1,1874
5,1,6,5,1,6,1,1875
1,0,1,1,0,1,1,1876
0,1,1,0,1,1,1,1877
1,1,2,1,1,2,1,1878
4,5,9,4,5,9,1,1879
6,1,7,6,1,7,1,1880
1,3,4,1,3,4,1,1881
4,0,4,4,0,4,1,1882
0,0,0,0,0,0,1,1883
20,11,31,20,11,31,1,1884
1,0,1,1,0,1,1,1885
0,1,1,0,1,1,1,1886
18,7,25,18,7,25,1,1887
12,7,19,12,7,19,1,1888
6,2,8,6,2,8,1,1889
0,0,0,0,0,0,1,1890
6,2,8,6,2,8,1,1891
7,2,9,7,2,9,1,1892
2,3,5,2,3,5,1,1893
7,1,8,7,1,8,1,1894
2,0,2,2,0,2,1,1895
6,21,27,6,21,27,1,1896
7,1,8,7,1,8,1,1897
1,1,2,1,1,2,1,1898
1,3,4,1,3,4,1,1899
4,2,6,4,2,6,1,1900
4,3,7,4,3,7,1,1901
5,1,6,5,1,6,1,1902
0,0,0,0,0,0,1,1903
11,13,24,11,13,24,1,1904
1,0,1,1,0,1,1,1905
3,1,4,3,1,4,1,1906
4,0,4,4,0,4,1,1907
1,6,7,1,6,7,1,1908
1,1,2,1,1,2,1,1909
0,1,1,0,1,1,1,1910
2,3,5,2,3,5,1,1911
2,0,2,2,0,2,1,1912
5,0,5,5,0,5,1,1913
11,0,11,11,0,11,1,1914
5,0,5,5,0,5,1,1915
2,0,2,2,0,2,1,1916
2,1,3,2,1,3,1,1917
4,10,14,4,10,14,1,1918
49,21,70,49,21,70,1,1919
1,1,2,1,1,2,1,1920
2,4,6,2,4,6,1,1921
3,0,3,3,0,3,1,1922
15,9,24,15,9,24,1,1923
65,45,110,65,45,110,1,1924
7,2,9,7,2,9,1,1925
0,2,2,0,2,2,1,1926
18,10,28,18,10,28,1,1927
2,0,2,2,0,2,1,1928
2,2,4,2,2,4,1,1929
3,0,3,3,0,3,1,1930
4,2,6,4,2,6,1,1931
10,3,13,10,3,13,1,1932
12,5,17,12,5,17,1,1933
1,4,5,1,4,5,1,1934
1,0,1,1,0,1,1,1935
4,3,7,4,3,7,1,1936
3,1,4,3,1,4,1,1937
10,3,13,10,3,13,1,1938
6,10,16,6,10,16,1,1939
4,2,6,4,2,6,1,1940
4,4,8,4,4,8,1,1941
15,4,19,15,4,19,1,1942
4,2,6,4,2,6,1,1943
13,4,17,13,4,17,1,1944
0,3,3,0,3,3,1,1945
2,2,4,2,2,4,1,1946
2,4,6,2,4,6,1,1947
7,6,13,7,6,13,1,1948
1,4,5,1,4,5,1,1949
10,8,18,10,8,18,1,1950
36,23,59,36,23,59,1,1951
15,11,26,15,11,26,1,1952
0,0,0,0,0,0,1,1953
0,0,0,0,0,0,1,1954
1,1,2,1,1,2,1,1955
3,4,7,3,4,7,1,1956
7,2,9,7,2,9,1,1957
2,5,7,2,5,7,1,1958
2,1,3,2,1,3,1,1959
2,0,2,2,0,2,1,1960
1,1,2,1,1,2,1,1961
1,0,1,1,0,1,1,1962
2,4,6,2,4,6,1,1963
2,1,3,2,1,3,1,1964
0,0,0,0,0,0,1,1965
10,4,14,10,4,14,1,1966
1,0,1,1,0,1,1,1967
1,0,1,1,0,1,1,1968
3,5,8,3,5,8,1,1969
0,2,2,0,2,2,1,1970
0,0,0,0,0,0,1,1971
78,20,98,78,20,98,1,1972
6,0,6,6,0,6,1,1973
6,3,9,6,3,9,1,1974
0,0,0,0,0,0,1,1975
7,0,7,7,0,7,1,1976
2,4,6,2,4,6,1,1977
15,21,36,15,21,36,1,1978
2224,3020,5244,2224,3020,5244,1,1979
1194,2111,3305,1194,2111,3305,1,1980
169,105,274,169,105,274,1,1981
476,1351,1827,476,1351,1827,1,1982
917,2623,3540,917,2623,3540,1,1983
30,55,85,30,55,85,1,1984
15,31,46,15,31,46,1,1985
1224,1179,2403,1224,1179,2403,1,1986
2155,4964,7119,2155,4964,7119,1,1987
14,4,18,14,4,18,1,1988
118,61,179,118,61,179,1,1989
319,233,552,319,233,552,1,1990
58,8,66,58,8,66,1,1991
75,89,164,75,89,164,1,1992
68,137,205,68,137,205,1,1993
182,243,425,182,243,425,1,1994
343,264,607,343,264,607,1,1995
61,74,135,61,74,135,1,1996
103,153,256,103,153,256,1,1997
7,14,21,7,14,21,1,1998
6,15,21,6,15,21,1,1999
17,10,27,17,10,27,1,2000
32,2,34,32,2,34,1,2001
4,1,5,4,1,5,1,2002
38,4,42,38,4,42,1,2003
12,6,18,12,6,18,1,2004
3,6,9,3,6,9,1,2005
0,2,2,0,2,2,1,2006
0,0,0,0,0,0,1,2007
2,0,2,2,0,2,1,2008
17,10,27,17,10,27,1,2009
3,2,5,3,2,5,1,2010
0,1,1,0,1,1,1,2011
1,0,1,1,0,1,1,2012
1,5,6,1,5,6,1,2013
3106,3052,6158,3106,3052,6158,1,2014
446,494,940,446,494,940,1,2015
243,186,429,243,186,429,1,2016
216,173,389,216,173,389,1,2017
79,54,133,79,54,133,1,2018
26,63,89,26,63,89,1,2019
11,9,20,11,9,20,1,2020
60,34,94,60,34,94,1,2021
129,186,315,129,186,315,1,2022
355,317,672,355,317,672,1,2023
170,161,331,170,161,331,1,2024
351,303,654,351,303,654,1,2025
15,5,20,15,5,20,1,2026
8,8,16,8,8,16,1,2027
1,2,3,1,2,3,1,2028
0,2,2,0,2,2,1,2029
122,35,157,122,35,157,1,2030
15,5,20,15,5,20,1,2031
11,7,18,11,7,18,1,2032
1,4,5,1,4,5,1,2033
57,107,164,57,107,164,1,2034
33,20,53,33,20,53,1,2035
20,12,32,20,12,32,1,2036
4,2,6,4,2,6,1,2037
9,6,15,9,6,15,1,2038
6,8,14,6,8,14,1,2039
2,2,4,2,2,4,1,2040
25,12,37,25,12,37,1,2041
2,2,4,2,2,4,1,2042
20,22,42,20,22,42,1,2043
2171,5055,7226,2171,5055,7226,1,2044
69,52,121,69,52,121,1,2045
7,5,12,7,5,12,1,2046
1,2,3,1,2,3,1,2047
2,0,2,2,0,2,1,2048
3,1,4,3,1,4,1,2049
2,2,4,2,2,4,1,2050
0,4,4,0,4,4,1,2051
251,284,535,251,284,535,1,2052
68,66,134,68,66,134,1,2053
65,125,190,65,125,190,1,2054
105,185,290,105,185,290,1,2055
185,72,257,185,72,257,1,2056
20,12,32,20,12,32,1,2057
0,0,0,0,0,0,1,2058
4,1,5,4,1,5,1,2059
1,4,5,1,4,5,1,2060
0,1,1,0,1,1,1,2061
2,0,2,2,0,2,1,2062
12,35,47,12,35,47,1,2063
0,1,1,0,1,1,1,2064
2,2,4,2,2,4,1,2065
13,3,16,13,3,16,1,2066
6,8,14,6,8,14,1,2067
37,99,136,37,99,136,1,2068
12,20,32,12,20,32,1,2069
0,1,1,0,1,1,1,2070
4,3,7,4,3,7,1,2071
1,2,3,1,2,3,1,2072
0,1,1,0,1,1,1,2073
80,376,456,80,376,456,1,2074
1,2,3,1,2,3,1,2075
2,0,2,2,0,2,1,2076
0,0,0,0,0,0,1,2077
0,4,4,0,4,4,1,2078
11,5,16,11,5,16,1,2079
16,34,50,16,34,50,1,2080
6397,11470,17867,6397,11470,17867,1,2081
0,0,0,0,0,0,1,2082
0,1,1,0,1,1,1,2083
0,0,0,0,0,0,1,2084
0,1,1,0,1,1,1,2085
0,0,0,0,0,0,1,2086
0,1,1,0,1,1,1,2087
9,12,21,9,12,21,1,2088
1,0,1,1,0,1,1,2089
2,10,12,2,10,12,1,2090
1,2,3,1,2,3,1,2091
2,4,6,2,4,6,1,2092
0,0,0,0,0,0,1,2093
0,2,2,0,2,2,1,2094
0,0,0,0,0,0,1,2095
0,0,0,0,0,0,1,2096
0,1,1,0,1,1,1,2097
0,0,0,0,0,0,1,2098
0,1,1,0,1,1,1,2099
1,4,5,1,4,5,1,2100
2,0,2,2,0,2,1,2101
0,0,0,0,0,0,1,2102
1,0,1,1,0,1,1,2103
0,0,0,0,0,0,1,2104
2,3,5,2,3,5,1,2105
0,0,0,0,0,0,1,2106
0,1,1,0,1,1,1,2107
1,0,1,1,0,1,1,2108
0,1,1,0,1,1,1,2109
0,1,1,0,1,1,1,2110
4,28,32,4,28,32,1,2111
0,0,0,0,0,0,1,2112
0,0,0,0,0,0,1,2113
1,1,2,1,1,2,1,2114
0,0,0,0,0,0,1,2115
0,0,0,0,0,0,1,2116
2,2,4,2,2,4,1,2117
0,0,0,0,0,0,1,2118
0,0,0,0,0,0,1,2119
1,0,1,1,0,1,1,2120
0,0,0,0,0,0,1,2121
0,1,1,0,1,1,1,2122
0,0,0,0,0,0,1,2123
1,0,1,1,0,1,1,2124
0,2,2,0,2,2,1,2125
0,0,0,0,0,0,1,2126
0,0,0,0,0,0,1,2127
0,0,0,0,0,0,1,2128
0,2,2,0,2,2,1,2129
0,2,2,0,2,2,1,2130
0,0,0,0,0,0,1,2131
0,1,1,0,1,1,1,2132
0,1,1,0,1,1,1,2133
0,0,0,0,0,0,1,2134
0,0,0,0,0,0,1,2135
2,2,4,2,2,4,1,2136
1,0,1,1,0,1,1,2137
0,1,1,0,1,1,1,2138
0,0,0,0,0,0,1,2139
0,0,0,0,0,0,1,2140
39,31,70,39,31,70,1,2141
134,101,235,134,101,235,1,2142
15,5,20,15,5,20,1,2143
5,3,8,5,3,8,1,2144
22,6,28,22,6,28,1,2145
15,4,19,15,4,19,1,2146
44,53,97,44,53,97,1,2147
26,52,78,26,52,78,1,2148
11,32,43,11,32,43,1,2149
238,400,638,238,400,638,1,2150
77,172,249,77,172,249,1,2151
24,55,79,24,55,79,1,2152
47,24,71,47,24,71,1,2153
119,109,228,119,109,228,1,2154
83,83,166,83,83,166,1,2155
12,11,23,12,11,23,1,2156
12,16,28,12,16,28,1,2157
0,4,4,0,4,4,1,2158
11,5,16,11,5,16,1,2159
16,8,24,16,8,24,1,2160
12,17,29,12,17,29,1,2161
75,56,131,75,56,131,1,2162
28,16,44,28,16,44,1,2163
58,147,205,58,147,205,1,2164
38,41,79,38,41,79,1,2165
91,81,172,91,81,172,1,2166
72,42,114,72,42,114,1,2167
52,22,74,52,22,74,1,2168
32,4,36,32,4,36,1,2169
5,1,6,5,1,6,1,2170
8,12,20,8,12,20,1,2171
468,511,979,468,511,979,1,2172
8,4,12,8,4,12,1,2173
11,50,61,11,50,61,1,2174
14,0,14,14,0,14,1,2175
22,6,28,22,6,28,1,2176
3,2,5,3,2,5,1,2177
51,9,60,51,9,60,1,2178
1,0,1,1,0,1,1,2179
1,0,1,1,0,1,1,2180
2,2,4,2,2,4,1,2181
6,3,9,6,3,9,1,2182
2,2,4,2,2,4,1,2183
4,2,6,4,2,6,1,2184
0,1,1,0,1,1,1,2185
8,8,16,8,8,16,1,2186
0,6,6,0,6,6,1,2187
12,7,19,12,7,19,1,2188
4,1,5,4,1,5,1,2189
4,3,7,4,3,7,1,2190
5,7,12,5,7,12,1,2191
3,1,4,3,1,4,1,2192
0,3,3,0,3,3,1,2193
2,6,8,2,6,8,1,2194
10,1,11,10,1,11,1,2195
3,3,6,3,3,6,1,2196
12,6,18,12,6,18,1,2197
42,29,71,42,29,71,1,2198
90,43,133,90,43,133,1,2199
628,242,870,628,242,870,1,2200
88,33,121,88,33,121,1,2201
9,3,12,9,3,12,1,2202
1,0,1,1,0,1,1,2203
12,3,15,12,3,15,1,2204
5,4,9,5,4,9,1,2205
0,0,0,0,0,0,1,2206
4,1,5,4,1,5,1,2207
0,1,1,0,1,1,1,2208
1,0,1,1,0,1,1,2209
6,2,8,6,2,8,1,2210
6,6,12,6,6,12,1,2211
3,2,5,3,2,5,1,2212
16,13,29,16,13,29,1,2213
7,4,11,7,4,11,1,2214
0,3,3,0,3,3,1,2215
3,0,3,3,0,3,1,2216
2,0,2,2,0,2,1,2217
2,2,4,2,2,4,1,2218
1,2,3,1,2,3,1,2219
1,0,1,1,0,1,1,2220
0,9,9,0,9,9,1,2221
7,1,8,7,1,8,1,2222
5,0,5,5,0,5,1,2223
2,5,7,2,5,7,1,2224
0,1,1,0,1,1,1,2225
2,1,3,2,1,3,1,2226
1,3,4,1,3,4,1,2227
17,3,20,17,3,20,1,2228
6,2,8,6,2,8,1,2229
1,1,2,1,1,2,1,2230
4,17,21,4,17,21,1,2231
1,1,2,1,1,2,1,2232
9,1,10,9,1,10,1,2233
1,0,1,1,0,1,1,2234
5,1,6,5,1,6,1,2235
4,1,5,4,1,5,1,2236
1,3,4,1,3,4,1,2237
1,0,1,1,0,1,1,2238
2,0,2,2,0,2,1,2239
0,1,1,0,1,1,1,2240
1,0,1,1,0,1,1,2241
0,0,0,0,0,0,1,2242
5,6,11,5,6,11,1,2243
0,1,1,0,1,1,1,2244
2,1,3,2,1,3,1,2245
4,0,4,4,0,4,1,2246
3,14,17,3,14,17,1,2247
1,1,2,1,1,2,1,2248
7,1,8,7,1,8,1,2249
4596,9503,14099,4596,9503,14099,1,2250
4,8,12,4,8,12,1,2251
4,3,7,4,3,7,1,2252
0,0,0,0,0,0,1,2253
1,0,1,1,0,1,1,2254
3,3,6,3,3,6,1,2255
0,0,0,0,0,0,1,2256
229,104,333,229,104,333,1,2257
2,8,10,2,8,10,1,2258
3,0,3,3,0,3,1,2259
1,2,3,1,2,3,1,2260
2,0,2,2,0,2,1,2261
2,0,2,2,0,2,1,2262
1,1,2,1,1,2,1,2263
1,0,1,1,0,1,1,2264
0,1,1,0,1,1,1,2265
0,0,0,0,0,0,1,2266
1,0,1,1,0,1,1,2267
0,1,1,0,1,1,1,2268
3,1,4,3,1,4,1,2269
0,4,4,0,4,4,1,2270
1,6,7,1,6,7,1,2271
0,0,0,0,0,0,1,2272
1,0,1,1,0,1,1,2273
14,0,14,14,0,14,1,2274
1,2,3,1,2,3,1,2275
1,5,6,1,5,6,1,2276
0,0,0,0,0,0,1,2277
18,36,54,18,36,54,1,2278
3,2,5,3,2,5,1,2279
12,38,50,12,38,50,1,2280
0,0,0,0,0,0,1,2281
4,0,4,4,0,4,1,2282
0,0,0,0,0,0,1,2283
1,1,2,1,1,2,1,2284
2,1,3,2,1,3,1,2285
1,1,2,1,1,2,1,2286
0,0,0,0,0,0,1,2287
1,0,1,1,0,1,1,2288
3,0,3,3,0,3,1,2289
0,0,0,0,0,0,1,2290
1,0,1,1,0,1,1,2291
4,0,4,4,0,4,1,2292
2,0,2,2,0,2,1,2293
1,1,2,1,1,2,1,2294
0,1,1,0,1,1,1,2295
28,30,58,28,30,58,1,2296
0,0,0,0,0,0,1,2297
134,124,258,134,124,258,1,2298
71,65,136,71,65,136,1,2299
52,41,93,52,41,93,1,2300
8,4,12,8,4,12,1,2301
2,5,7,2,5,7,1,2302
11,3,14,11,3,14,1,2303
4,0,4,4,0,4,1,2304
5,0,5,5,0,5,1,2305
1,3,4,1,3,4,1,2306
0,1,1,0,1,1,1,2307
8,5,13,8,5,13,1,2308
0,1,1,0,1,1,1,2309
0,0,0,0,0,0,1,2310
0,3,3,0,3,3,1,2311
0,0,0,0,0,0,1,2312
0,0,0,0,0,0,1,2313
1,0,1,1,0,1,1,2314
3,0,3,3,0,3,1,2315
33,41,74,33,41,74,1,2316
23,42,65,23,42,65,1,2317
73,158,231,73,158,231,1,2318
3,1,4,3,1,4,1,2319
16,3,19,16,3,19,1,2320
27,4,31,27,4,31,1,2321
1578,1649,3227,1578,1649,3227,1,2322
11,3,14,11,3,14,1,2323
14,2,16,14,2,16,1,2324
8,4,12,8,4,12,1,2325
21,15,36,21,15,36,1,2326
24,11,35,24,11,35,1,2327
18,2,20,18,2,20,1,2328
825,631,1456,825,631,1456,1,2329
4123,2352,6475,4123,2352,6475,1,2330
0,4,4,0,4,4,1,2331
43,132,175,43,132,175,1,2332
3,7,10,3,7,10,1,2333
8,23,31,8,23,31,1,2334
2,16,18,2,16,18,1,2335
11,104,115,11,104,115,1,2336
5,20,25,5,20,25,1,2337
217,106,323,217,106,323,1,2338
117,102,219,117,102,219,1,2339
18,10,28,18,10,28,1,2340
15,31,46,15,31,46,1,2341
294,75,369,294,75,369,1,2342
341,90,431,341,90,431,1,2343
118,23,141,118,23,141,1,2344
7,6,13,7,6,13,1,2345
16,5,21,16,5,21,1,2346
13,0,13,13,0,13,1,2347
11,9,20,11,9,20,1,2348
8,4,12,8,4,12,1,2349
12,10,22,12,10,22,1,2350
44,21,65,44,21,65,1,2351
3,0,3,3,0,3,1,2352
94,43,137,94,43,137,1,2353
15,23,38,15,23,38,1,2354
16,9,25,16,9,25,1,2355
8,16,24,8,16,24,1,2356
32,3,35,32,3,35,1,2357
4,3,7,4,3,7,1,2358
3,0,3,3,0,3,1,2359
9,1,10,9,1,10,1,2360
1,2,3,1,2,3,1,2361
37,5,42,37,5,42,1,2362
1434,632,2066,1434,632,2066,1,2363
714,993,1707,714,993,1707,1,2364
12,9,21,12,9,21,1,2365
10,24,34,10,24,34,1,2366
3,1,4,3,1,4,1,2367
37,2,39,37,2,39,1,2368
118,195,313,118,195,313,1,2369
2,6,8,2,6,8,1,2370
4,2,6,4,2,6,1,2371
29,4,33,29,4,33,1,2372
19,2,21,19,2,21,1,2373
77,32,109,77,32,109,1,2374
40,11,51,40,11,51,1,2375
9,1,10,9,1,10,1,2376
10,3,13,10,3,13,1,2377
9,0,9,9,0,9,1,2378
7,7,14,7,7,14,1,2379
2,2,4,2,2,4,1,2380
15,6,21,15,6,21,1,2381
8,4,12,8,4,12,1,2382
40,94,134,40,94,134,1,2383
72,149,221,72,149,221,1,2384
1,0,1,1,0,1,1,2385
1,8,9,1,8,9,1,2386
0,0,0,0,0,0,1,2387
1,0,1,1,0,1,1,2388
0,0,0,0,0,0,1,2389
15,12,27,15,12,27,1,2390
1,1,2,1,1,2,1,2391
2,3,5,2,3,5,1,2392
2,0,2,2,0,2,1,2393
1,5,6,1,5,6,1,2394
1,1,2,1,1,2,1,2395
1,0,1,1,0,1,1,2396
4,1,5,4,1,5,1,2397
3,7,10,3,7,10,1,2398
4,6,10,4,6,10,1,2399
8,34,42,8,34,42,1,2400
9,1,10,9,1,10,1,2401
1,1,2,1,1,2,1,2402
2,2,4,2,2,4,1,2403
11,5,16,11,5,16,1,2404
44,59,103,44,59,103,1,2405
10,7,17,10,7,17,1,2406
10,11,21,10,11,21,1,2407
797,486,1283,797,486,1283,1,2408
2,0,2,2,0,2,1,2409
0,3,3,0,3,3,1,2410
6,6,12,6,6,12,1,2411
0,0,0,0,0,0,1,2412
11,19,30,11,19,30,1,2413
19,21,40,19,21,40,1,2414
1,6,7,1,6,7,1,2415
2,3,5,2,3,5,1,2416
0,5,5,0,5,5,1,2417
0,13,13,0,13,13,1,2418
2,1,3,2,1,3,1,2419
0,0,0,0,0,0,1,2420
6,3,9,6,3,9,1,2421
3,6,9,3,6,9,1,2422
1,0,1,1,0,1,1,2423
1,0,1,1,0,1,1,2424
0,0,0,0,0,0,1,2425
0,4,4,0,4,4,1,2426
2,10,12,2,10,12,1,2427
0,0,0,0,0,0,1,2428
148,136,284,148,136,284,1,2429
3,2,5,3,2,5,1,2430
6,2,8,6,2,8,1,2431
21,4,25,21,4,25,1,2432
24,16,40,24,16,40,1,2433
3,1,4,3,1,4,1,2434
0,1,1,0,1,1,1,2435
2,2,4,2,2,4,1,2436
2,6,8,2,6,8,1,2437
2,6,8,2,6,8,1,2438
1,0,1,1,0,1,1,2439
1,0,1,1,0,1,1,2440
20,109,129,20,109,129,1,2441
0,1,1,0,1,1,1,2442
1,9,10,1,9,10,1,2443
2,4,6,2,4,6,1,2444
2,0,2,2,0,2,1,2445
92,37,129,92,37,129,1,2446
17,14,31,17,14,31,1,2447
16,21,37,16,21,37,1,2448
13,11,24,13,11,24,1,2449
24,10,34,24,10,34,1,2450
30,7,37,30,7,37,1,2451
0,0,0,0,0,0,1,2452
0,0,0,0,0,0,1,2453
14,0,14,14,0,14,1,2454
43,5,48,43,5,48,1,2455
19,10,29,19,10,29,1,2456
6886,5558,12444,6886,5558,12444,1,2457
7,1,8,7,1,8,1,2458
271,633,904,271,633,904,1,2459
39,8,47,39,8,47,1,2460
14,3,17,14,3,17,1,2461
9,2,11,9,2,11,1,2462
2,4,6,2,4,6,1,2463
2,1,3,2,1,3,1,2464
13,6,19,13,6,19,1,2465
30,13,43,30,13,43,1,2466
4,12,16,4,12,16,1,2467
13,5,18,13,5,18,1,2468
0,1,1,0,1,1,1,2469
0,2,2,0,2,2,1,2470
1,0,1,1,0,1,1,2471
2,2,4,2,2,4,1,2472
0,2,2,0,2,2,1,2473
1,1,2,1,1,2,1,2474
4,0,4,4,0,4,1,2475
11,14,25,11,14,25,1,2476
187,71,258,187,71,258,1,2477
5,4,9,5,4,9,1,2478
9,7,16,9,7,16,1,2479
8,4,12,8,4,12,1,2480
31,7,38,31,7,38,1,2481
23,10,33,23,10,33,1,2482
1,1,2,1,1,2,1,2483
0,1,1,0,1,1,1,2484
0,0,0,0,0,0,1,2485
0,0,0,0,0,0,1,2486
3,0,3,3,0,3,1,2487
1,2,3,1,2,3,1,2488
0,1,1,0,1,1,1,2489
0,0,0,0,0,0,1,2490
1,0,1,1,0,1,1,2491
0,0,0,0,0,0,1,2492
1,0,1,1,0,1,1,2493
1,1,2,1,1,2,1,2494
0,0,0,0,0,0,1,2495
17,5,22,17,5,22,1,2496
6,1,7,6,1,7,1,2497
29,9,38,29,9,38,1,2498
3,1,4,3,1,4,1,2499
4,4,8,4,4,8,1,2500
0,1,1,0,1,1,1,2501
5,9,14,5,9,14,1,2502
6872,9081,15953,6872,9081,15953,1,2503
2,2,4,2,2,4,1,2504
0,1,1,0,1,1,1,2505
4,2,6,4,2,6,1,2506
1,0,1,1,0,1,1,2507
0,1,1,0,1,1,1,2508
2,2,4,2,2,4,1,2509
0,0,0,0,0,0,1,2510
4,2,6,4,2,6,1,2511
2,0,2,2,0,2,1,2512
3,1,4,3,1,4,1,2513
2,0,2,2,0,2,1,2514
3,0,3,3,0,3,1,2515
2,0,2,2,0,2,1,2516
89,39,128,89,39,128,1,2517
119,244,363,119,244,363,1,2518
40,15,55,40,15,55,1,2519
6,5,11,6,5,11,1,2520
1,0,1,1,0,1,1,2521
0,1,1,0,1,1,1,2522
4,3,7,4,3,7,1,2523
7,2,9,7,2,9,1,2524
2,0,2,2,0,2,1,2525
6,0,6,6,0,6,1,2526
19,52,71,19,52,71,1,2527
32,32,64,32,32,64,1,2528
6,2,8,6,2,8,1,2529
1,5,6,1,5,6,1,2530
8,11,19,8,11,19,1,2531
59,11,70,59,11,70,1,2532
3,6,9,3,6,9,1,2533
28,28,56,28,28,56,1,2534
11,7,18,11,7,18,1,2535
1,2,3,1,2,3,1,2536
1,0,1,1,0,1,1,2537
57,49,106,57,49,106,1,2538
2380,2185,4565,2380,2185,4565,1,2539
357,181,538,357,181,538,1,2540
1,0,1,1,0,1,1,2541
4,2,6,4,2,6,1,2542
82,12,94,82,12,94,1,2543
84,41,125,84,41,125,1,2544
115,23,138,115,23,138,1,2545
30,28,58,30,28,58,1,2546
46,26,72,46,26,72,1,2547
0,5,5,0,5,5,1,2548
27,11,38,27,11,38,1,2549
23,11,34,23,11,34,1,2550
3,1,4,3,1,4,1,2551
14,15,29,14,15,29,1,2552
0,0,0,0,0,0,1,2553
0,3,3,0,3,3,1,2554
6,4,10,6,4,10,1,2555
1,2,3,1,2,3,1,2556
0,0,0,0,0,0,1,2557
292,347,639,292,347,639,1,2558
11,3,14,11,3,14,1,2559
25,6,31,25,6,31,1,2560
5,0,5,5,0,5,1,2561
1,0,1,1,0,1,1,2562
5,1,6,5,1,6,1,2563
11,2,13,11,2,13,1,2564
7,1,8,7,1,8,1,2565
0,0,0,0,0,0,1,2566
1,0,1,1,0,1,1,2567
7,13,20,7,13,20,1,2568
11,11,22,11,11,22,1,2569
21,11,32,21,11,32,1,2570
265,139,404,265,139,404,1,2571
0,1,1,0,1,1,1,2572
45,18,63,45,18,63,1,2573
7,0,7,7,0,7,1,2574
4,1,5,4,1,5,1,2575
0,0,0,0,0,0,1,2576
1,6,7,1,6,7,1,2577
0,0,0,0,0,0,1,2578
1,0,1,1,0,1,1,2579
96,34,130,96,34,130,1,2580
22,4,26,22,4,26,1,2581
182,117,299,182,117,299,1,2582
44,3,47,44,3,47,1,2583
53,70,123,53,70,123,1,2584
1,0,1,1,0,1,1,2585
22,3,25,22,3,25,1,2586
5,2,7,5,2,7,1,2587
6,21,27,6,21,27,1,2588
9,5,14,9,5,14,1,2589
4,3,7,4,3,7,1,2590
3,1,4,3,1,4,1,2591
14,4,18,14,4,18,1,2592
8,6,14,8,6,14,1,2593
18,7,25,18,7,25,1,2594
45,19,64,45,19,64,1,2595
3,4,7,3,4,7,1,2596
7,15,22,7,15,22,1,2597
18,10,28,18,10,28,1,2598
23,10,33,23,10,33,1,2599
4,1,5,4,1,5,1,2600
1,6,7,1,6,7,1,2601
124,7,131,124,7,131,1,2602
80,189,269,80,189,269,1,2603
183,108,291,183,108,291,1,2604
174,411,585,174,411,585,1,2605
5,3,8,5,3,8,1,2606
25,29,54,25,29,54,1,2607
106,27,133,106,27,133,1,2608
61,29,90,61,29,90,1,2609
4,4,8,4,4,8,1,2610
32,21,53,32,21,53,1,2611
1,0,1,1,0,1,1,2612
13,6,19,13,6,19,1,2613
47,206,253,47,206,253,1,2614
47,22,69,47,22,69,1,2615
41,10,51,41,10,51,1,2616
108,21,129,108,21,129,1,2617
35,4,39,35,4,39,1,2618
5,5,10,5,5,10,1,2619
176,763,939,176,763,939,1,2620
18,15,33,18,15,33,1,2621
24,31,55,24,31,55,1,2622
4802,1485,6287,4802,1485,6287,1,2623
20,9,29,20,9,29,1,2624
6,0,6,6,0,6,1,2625
6,4,10,6,4,10,1,2626
5,0,5,5,0,5,1,2627
11,6,17,11,6,17,1,2628
17,18,35,17,18,35,1,2629
36,11,47,36,11,47,1,2630
10,0,10,10,0,10,1,2631
449,495,944,449,495,944,1,2632
1759,4206,5965,1759,4206,5965,1,2633
452,247,699,452,247,699,1,2634
2,0,2,2,0,2,1,2635
2,1,3,2,1,3,1,2636
22,6,28,22,6,28,1,2637
20,9,29,20,9,29,1,2638
2,2,4,2,2,4,1,2639
5,1,6,5,1,6,1,2640
1108,1020,2128,1108,1020,2128,1,2641
289,229,518,289,229,518,1,2642
1,3,4,1,3,4,1,2643
1,4,5,1,4,5,1,2644
16,8,24,16,8,24,1,2645
46,31,77,46,31,77,1,2646
1,0,1,1,0,1,1,2647
15,4,19,15,4,19,1,2648
4,0,4,4,0,4,1,2649
3,0,3,3,0,3,1,2650
4,3,7,4,3,7,1,2651
1,2,3,1,2,3,1,2652
85,80,165,85,80,165,1,2653
10,4,14,10,4,14,1,2654
4,5,9,4,5,9,1,2655
1,0,1,1,0,1,1,2656
5,4,9,5,4,9,1,2657
3,4,7,3,4,7,1,2658
8,0,8,8,0,8,1,2659
43,14,57,43,14,57,1,2660
8812,3899,12711,8812,3899,12711,1,2661
6,6,12,6,6,12,1,2662
37,51,88,37,51,88,1,2663
737,151,888,737,151,888,1,2664
19,4,23,19,4,23,1,2665
8,0,8,8,0,8,1,2666
6,3,9,6,3,9,1,2667
242,116,358,242,116,358,1,2668
3,0,3,3,0,3,1,2669
401,66,467,401,66,467,1,2670
9,0,9,9,0,9,1,2671
5,1,6,5,1,6,1,2672
8,6,14,8,6,14,1,2673
11,4,15,11,4,15,1,2674
9,1,10,9,1,10,1,2675
34,8,42,34,8,42,1,2676
31,6,37,31,6,37,1,2677
320,69,389,320,69,389,1,2678
107,387,494,107,387,494,1,2679
2264,4757,7021,2264,4757,7021,1,2680
33,75,108,33,75,108,1,2681
3,5,8,3,5,8,1,2682
31,8,39,31,8,39,1,2683
70,53,123,70,53,123,1,2684
27,2,29,27,2,29,1,2685
51,24,75,51,24,75,1,2686
1,1,2,1,1,2,1,2687
2,1,3,2,1,3,1,2688
3,1,4,3,1,4,1,2689
8,6,14,8,6,14,1,2690
2,0,2,2,0,2,1,2691
2,3,5,2,3,5,1,2692
1,4,5,1,4,5,1,2693
0,1,1,0,1,1,1,2694
1,2,3,1,2,3,1,2695
5,4,9,5,4,9,1,2696
2,0,2,2,0,2,1,2697
0,1,1,0,1,1,1,2698
3,2,5,3,2,5,1,2699
2,2,4,2,2,4,1,2700
29,12,41,29,12,41,1,2701
3,1,4,3,1,4,1,2702
4,3,7,4,3,7,1,2703
116,183,299,116,183,299,1,2704
17134,16895,34029,17134,16895,34029,1,2705
22,13,35,22,13,35,1,2706
33,21,54,33,21,54,1,2707
2579,2444,5023,2579,2444,5023,1,2708
9,4,13,9,4,13,1,2709
7,4,11,7,4,11,1,2710
5,4,9,5,4,9,1,2711
4,5,9,4,5,9,1,2712
34,14,48,34,14,48,1,2713
49,27,76,49,27,76,1,2714
2,3,5,2,3,5,1,2715
1,0,1,1,0,1,1,2716
64,34,98,64,34,98,1,2717
2,1,3,2,1,3,1,2718
3,5,8,3,5,8,1,2719
3,0,3,3,0,3,1,2720
76,207,283,76,207,283,1,2721
40,31,71,40,31,71,1,2722
1387,4353,5740,1387,4353,5740,1,2723
71,546,617,71,546,617,1,2724
52,20,72,52,20,72,1,2725
36,21,57,36,21,57,1,2726
17,6,23,17,6,23,1,2727
1,0,1,1,0,1,1,2728
327,345,672,327,345,672,1,2729
48,39,87,48,39,87,1,2730
24,5,29,24,5,29,1,2731
85,18,103,85,18,103,1,2732
80,27,107,80,27,107,1,2733
9,9,18,9,9,18,1,2734
4,3,7,4,3,7,1,2735
193,654,847,193,654,847,1,2736
27,21,48,27,21,48,1,2737
2,4,6,2,4,6,1,2738
4,1,5,4,1,5,1,2739
0,1,1,0,1,1,1,2740
0,1,1,0,1,1,1,2741
1,0,1,1,0,1,1,2742
59,17,76,59,17,76,1,2743
54,115,169,54,115,169,1,2744
248,719,967,248,719,967,1,2745
213,601,814,213,601,814,1,2746
525,164,689,525,164,689,1,2747
370,181,551,370,181,551,1,2748
37,70,107,37,70,107,1,2749
41,185,226,41,185,226,1,2750
20,60,80,20,60,80,1,2751
2,0,2,2,0,2,1,2752
2,1,3,2,1,3,1,2753
2,4,6,2,4,6,1,2754
6,0,6,6,0,6,1,2755
1,0,1,1,0,1,1,2756
15,23,38,15,23,38,1,2757
11,44,55,11,44,55,1,2758
138,15,153,138,15,153,1,2759
8,7,15,8,7,15,1,2760
2,3,5,2,3,5,1,2761
2,1,3,2,1,3,1,2762
0,3,3,0,3,3,1,2763
0,0,0,0,0,0,1,2764
0,1,1,0,1,1,1,2765
2,2,4,2,2,4,1,2766
2,0,2,2,0,2,1,2767
1,1,2,1,1,2,1,2768
10,5,15,10,5,15,1,2769
4,5,9,4,5,9,1,2770
1,0,1,1,0,1,1,2771
0,0,0,0,0,0,1,2772
2,14,16,2,14,16,1,2773
11,32,43,11,32,43,1,2774
2260,2263,4523,2260,2263,4523,1,2775
7,4,11,7,4,11,1,2776
51,50,101,51,50,101,1,2777
18,17,35,18,17,35,1,2778
10,3,13,10,3,13,1,2779
32,42,74,32,42,74,1,2780
0,0,0,0,0,0,1,2781
5,9,14,5,9,14,1,2782
6,7,13,6,7,13,1,2783
24,45,69,24,45,69,1,2784
5,5,10,5,5,10,1,2785
27,21,48,27,21,48,1,2786
4,9,13,4,9,13,1,2787
8,8,16,8,8,16,1,2788
59,41,100,59,41,100,1,2789
0,0,0,0,0,0,1,2790
39,69,108,39,69,108,1,2791
2,3,5,2,3,5,1,2792
1,0,1,1,0,1,1,2793
2,1,3,2,1,3,1,2794
7,2,9,7,2,9,1,2795
2,9,11,2,9,11,1,2796
0,3,3,0,3,3,1,2797
1,5,6,1,5,6,1,2798
1,1,2,1,1,2,1,2799
0,2,2,0,2,2,1,2800
2,0,2,2,0,2,1,2801
1,8,9,1,8,9,1,2802
6,20,26,6,20,26,1,2803
1,1,2,1,1,2,1,2804
0,2,2,0,2,2,1,2805
0,0,0,0,0,0,1,2806
5,1,6,5,1,6,1,2807
6,5,11,6,5,11,1,2808
3,2,5,3,2,5,1,2809
1,1,2,1,1,2,1,2810
3,3,6,3,3,6,1,2811
11,5,16,11,5,16,1,2812
2,2,4,2,2,4,1,2813
13,2,15,13,2,15,1,2814
3,4,7,3,4,7,1,2815
4,0,4,4,0,4,1,2816
4,8,12,4,8,12,1,2817
0,3,3,0,3,3,1,2818
14,43,57,14,43,57,1,2819
2,2,4,2,2,4,1,2820
0,1,1,0,1,1,1,2821
3,3,6,3,3,6,1,2822
4,1,5,4,1,5,1,2823
4849,21497,26346,4849,21497,26346,1,2824
2055,2387,4442,2055,2387,4442,1,2825
3,2,5,3,2,5,1,2826
1,0,1,1,0,1,1,2827
32,1,33,32,1,33,1,2828
2,2,4,2,2,4,1,2829
0,0,0,0,0,0,1,2830
1,0,1,1,0,1,1,2831
0,1,1,0,1,1,1,2832
1,0,1,1,0,1,1,2833
0,3,3,0,3,3,1,2834
3,2,5,3,2,5,1,2835
5,3,8,5,3,8,1,2836
0,0,0,0,0,0,1,2837
0,0,0,0,0,0,1,2838
12,4,16,12,4,16,1,2839
9,7,16,9,7,16,1,2840
11,0,11,11,0,11,1,2841
15,8,23,15,8,23,1,2842
1,1,2,1,1,2,1,2843
4,0,4,4,0,4,1,2844
0,0,0,0,0,0,1,2845
7,3,10,7,3,10,1,2846
2,5,7,2,5,7,1,2847
13,48,61,13,48,61,1,2848
8,7,15,8,7,15,1,2849
22,68,90,22,68,90,1,2850
20,20,40,20,20,40,1,2851
0,1,1,0,1,1,1,2852
73,240,313,73,240,313,1,2853
23,31,54,23,31,54,1,2854
26,28,54,26,28,54,1,2855
35,98,133,35,98,133,1,2856
11,24,35,11,24,35,1,2857
19,14,33,19,14,33,1,2858
14,7,21,14,7,21,1,2859
15,36,51,15,36,51,1,2860
4,11,15,4,11,15,1,2861
7,3,10,7,3,10,1,2862
1,1,2,1,1,2,1,2863
0,0,0,0,0,0,1,2864
2,3,5,2,3,5,1,2865
0,0,0,0,0,0,1,2866
3,4,7,3,4,7,1,2867
0,0,0,0,0,0,1,2868
47,242,289,47,242,289,1,2869
1,0,1,1,0,1,1,2870
4,1,5,4,1,5,1,2871
46,34,80,46,34,80,1,2872
1,1,2,1,1,2,1,2873
4,10,14,4,10,14,1,2874
27,11,38,27,11,38,1,2875
2,2,4,2,2,4,1,2876
26,26,52,26,26,52,1,2877
12,6,18,12,6,18,1,2878
63,135,198,63,135,198,1,2879
9,50,59,9,50,59,1,2880
105,79,184,105,79,184,1,2881
43,102,145,43,102,145,1,2882
0,0,0,0,0,0,1,2883
27,17,44,27,17,44,1,2884
222,101,323,222,101,323,1,2885
9,27,36,9,27,36,1,2886
26,38,64,26,38,64,1,2887
73,27,100,73,27,100,1,2888
1951,740,2691,1951,740,2691,1,2889
25,89,114,25,89,114,1,2890
8,26,34,8,26,34,1,2891
25,80,105,25,80,105,1,2892
30,115,145,30,115,145,1,2893
179,686,865,179,686,865,1,2894
11,5,16,11,5,16,1,2895
0,0,0,0,0,0,1,2896
6,4,10,6,4,10,1,2897
6,14,20,6,14,20,1,2898
2,3,5,2,3,5,1,2899
104,189,293,104,189,293,1,2900
89,75,164,89,75,164,1,2901
9,14,23,9,14,23,1,2902
1,2,3,1,2,3,1,2903
0,2,2,0,2,2,1,2904
8,43,51,8,43,51,1,2905
0,0,0,0,0,0,1,2906
27,95,122,27,95,122,1,2907
4,4,8,4,4,8,1,2908
4,3,7,4,3,7,1,2909
7,47,54,7,47,54,1,2910
0,2,2,0,2,2,1,2911
32,145,177,32,145,177,1,2912
9,4,13,9,4,13,1,2913
5,1,6,5,1,6,1,2914
1,0,1,1,0,1,1,2915
2,0,2,2,0,2,1,2916
24,23,47,24,23,47,1,2917
6,2,8,6,2,8,1,2918
4,4,8,4,4,8,1,2919
2,2,4,2,2,4,1,2920
27,96,123,27,96,123,1,2921
4,3,7,4,3,7,1,2922
1,4,5,1,4,5,1,2923
1,0,1,1,0,1,1,2924
1,7,8,1,7,8,1,2925
14,22,36,14,22,36,1,2926
10,2,12,10,2,12,1,2927
1,6,7,1,6,7,1,2928
665,417,1082,665,417,1082,1,2929
61,91,152,61,91,152,1,2930
0,3,3,0,3,3,1,2931
3,8,11,3,8,11,1,2932
155,180,335,155,180,335,1,2933
1,6,7,1,6,7,1,2934
3,0,3,3,0,3,1,2935
819,351,1170,819,351,1170,1,2936
6,8,14,6,8,14,1,2937
1,6,7,1,6,7,1,2938
8,0,8,8,0,8,1,2939
35,8,43,35,8,43,1,2940
7,6,13,7,6,13,1,2941
1,1,2,1,1,2,1,2942
4,2,6,4,2,6,1,2943
2,2,4,2,2,4,1,2944
3,2,5,3,2,5,1,2945
165,20,185,165,20,185,1,2946
481,62,543,481,62,543,1,2947
19,2,21,19,2,21,1,2948
3,0,3,3,0,3,1,2949
0,0,0,0,0,0,1,2950
11,1,12,11,1,12,1,2951
112,208,320,112,208,320,1,2952
8,57,65,8,57,65,1,2953
18,10,28,18,10,28,1,2954
44,44,88,44,44,88,1,2955
12,8,20,12,8,20,1,2956
16,13,29,16,13,29,1,2957
0,0,0,0,0,0,1,2958
64,79,143,64,79,143,1,2959
191,234,425,191,234,425,1,2960
8,5,13,8,5,13,1,2961
13,16,29,13,16,29,1,2962
7,4,11,7,4,11,1,2963
9,1,10,9,1,10,1,2964
2,3,5,2,3,5,1,2965
0,1,1,0,1,1,1,2966
0,9,9,0,9,9,1,2967
4,2,6,4,2,6,1,2968
6219,15367,21586,6219,15367,21586,1,2969
0,0,0,0,0,0,1,2970
2,1,3,2,1,3,1,2971
0,1,1,0,1,1,1,2972
1,0,1,1,0,1,1,2973
1,3,4,1,3,4,1,2974
5,17,22,5,17,22,1,2975
7,10,17,7,10,17,1,2976
172,1201,1373,172,1201,1373,1,2977
2,4,6,2,4,6,1,2978
0,5,5,0,5,5,1,2979
0,1,1,0,1,1,1,2980
0,0,0,0,0,0,1,2981
0,1,1,0,1,1,1,2982
27,44,71,27,44,71,1,2983
12,6,18,12,6,18,1,2984
1,2,3,1,2,3,1,2985
0,8,8,0,8,8,1,2986
31,59,90,31,59,90,1,2987
49,174,223,49,174,223,1,2988
37,174,211,37,174,211,1,2989
0,1,1,0,1,1,1,2990
1,1,2,1,1,2,1,2991
0,2,2,0,2,2,1,2992
34,120,154,34,120,154,1,2993
0,0,0,0,0,0,1,2994
54,36,90,54,36,90,1,2995
0,0,0,0,0,0,1,2996
0,2,2,0,2,2,1,2997
0,1,1,0,1,1,1,2998
1,6,7,1,6,7,1,2999
1,24,25,1,24,25,1,3000
10,3,13,10,3,13,1,3001
77,27,104,77,27,104,1,3002
6,0,6,6,0,6,1,3003
6,3,9,6,3,9,1,3004
14,4,18,14,4,18,1,3005
1151,4918,6069,1151,4918,6069,1,3006
0,0,0,0,0,0,1,3007
1,0,1,1,0,1,1,3008
0,0,0,0,0,0,1,3009
0,0,0,0,0,0,1,3010
1,0,1,1,0,1,1,3011
0,0,0,0,0,0,1,3012
0,0,0,0,0,0,1,3013
2,0,2,2,0,2,1,3014
6,15,21,6,15,21,1,3015
121,243,364,121,243,364,1,3016
3,2,5,3,2,5,1,3017
0,1,1,0,1,1,1,3018
2,5,7,2,5,7,1,3019
1,0,1,1,0,1,1,3020
1,11,12,1,11,12,1,3021
1,1,2,1,1,2,1,3022
13,8,21,13,8,21,1,3023
1,0,1,1,0,1,1,3024
12,15,27,12,15,27,1,3025
7,0,7,7,0,7,1,3026
8,17,25,8,17,25,1,3027
0,2,2,0,2,2,1,3028
2,3,5,2,3,5,1,3029
2,0,2,2,0,2,1,3030
0,2,2,0,2,2,1,3031
2,3,5,2,3,5,1,3032
5,13,18,5,13,18,1,3033
1,8,9,1,8,9,1,3034
1,3,4,1,3,4,1,3035
7,5,12,7,5,12,1,3036
96,32,128,96,32,128,1,3037
125,108,233,125,108,233,1,3038
22,9,31,22,9,31,1,3039
111,278,389,111,278,389,1,3040
92,146,238,92,146,238,1,3041
14,10,24,14,10,24,1,3042
5,10,15,5,10,15,1,3043
191,327,518,191,327,518,1,3044
2,22,24,2,22,24,1,3045
0,0,0,0,0,0,1,3046
0,2,2,0,2,2,1,3047
1,0,1,1,0,1,1,3048
42,59,101,42,59,101,1,3049
123,108,231,123,108,231,1,3050
1,5,6,1,5,6,1,3051
10,4,14,10,4,14,1,3052
0,0,0,0,0,0,1,3053
0,0,0,0,0,0,1,3054
1,0,1,1,0,1,1,3055
5,1,6,5,1,6,1,3056
0,2,2,0,2,2,1,3057
23,12,35,23,12,35,1,3058
1,1,2,1,1,2,1,3059
1,1,2,1,1,2,1,3060
16,8,24,16,8,24,1,3061
13,82,95,13,82,95,1,3062
32,1,33,32,1,33,1,3063
1,0,1,1,0,1,1,3064
16,0,16,16,0,16,1,3065
4,0,4,4,0,4,1,3066
5,0,5,5,0,5,1,3067
1,0,1,1,0,1,1,3068
2,1,3,2,1,3,1,3069
1,2,3,1,2,3,1,3070
31,92,123,31,92,123,1,3071
2,3,5,2,3,5,1,3072
92,119,211,92,119,211,1,3073
21,15,36,21,15,36,1,3074
0,2,2,0,2,2,1,3075
1,0,1,1,0,1,1,3076
1,9,10,1,9,10,1,3077
1,2,3,1,2,3,1,3078
77,67,144,77,67,144,1,3079
0,0,0,0,0,0,1,3080
1,5,6,1,5,6,1,3081
4,19,23,4,19,23,1,3082
8,13,21,8,13,21,1,3083
6,0,6,6,0,6,1,3084
13,10,23,13,10,23,1,3085
6,20,26,6,20,26,1,3086
1,3,4,1,3,4,1,3087
2,0,2,2,0,2,1,3088
1,1,2,1,1,2,1,3089
2,0,2,2,0,2,1,3090
0,1,1,0,1,1,1,3091
3,1,4,3,1,4,1,3092
34,67,101,34,67,101,1,3093
19,15,34,19,15,34,1,3094
99,74,173,99,74,173,1,3095
1,1,2,1,1,2,1,3096
0,0,0,0,0,0,1,3097
7,4,11,7,4,11,1,3098
1,0,1,1,0,1,1,3099
0,0,0,0,0,0,1,3100
1,0,1,1,0,1,1,3101
9,9,18,9,9,18,1,3102
0,6,6,0,6,6,1,3103
5,13,18,5,13,18,1,3104
2,2,4,2,2,4,1,3105
0,0,0,0,0,0,1,3106
0,0,0,0,0,0,1,3107
0,0,0,0,0,0,1,3108
0,0,0,0,0,0,1,3109
0,0,0,0,0,0,1,3110
0,0,0,0,0,0,1,3111
138,283,421,138,283,421,1,3112
7,12,19,7,12,19,1,3113
2,4,6,2,4,6,1,3114
1,0,1,1,0,1,1,3115
0,4,4,0,4,4,1,3116
1,0,1,1,0,1,1,3117
1,0,1,1,0,1,1,3118
7,4,11,7,4,11,1,3119
0,2,2,0,2,2,1,3120
9,46,55,9,46,55,1,3121
26726,45419,72145,26726,45419,72145,1,3122
50,175,225,50,175,225,1,3123
30887,49120,80007,30887,49120,80007,1,3124
403,2193,2596,403,2193,2596,1,3125
7260,16773,24033,7260,16773,24033,1,3126
45,135,180,45,135,180,1,3127
85,453,538,85,453,538,1,3128
31,77,108,31,77,108,1,3129
10629,29578,40207,10629,29578,40207,1,3130
23,104,127,23,104,127,1,3131
0,1,1,0,1,1,1,3132
0,0,0,0,0,0,1,3133
9,18,27,9,18,27,1,3134
17,21,38,17,21,38,1,3135
67,94,161,67,94,161,1,3136
30,42,72,30,42,72,1,3137
45,124,169,45,124,169,1,3138
12,41,53,12,41,53,1,3139
83,126,209,83,126,209,1,3140
67,148,215,67,148,215,1,3141
80,213,293,80,213,293,1,3142
46,149,195,46,149,195,1,3143
28,83,111,28,83,111,1,3144
84,145,229,84,145,229,1,3145
83,146,229,83,146,229,1,3146
313,596,909,313,596,909,1,3147
2296,8663,10959,2296,8663,10959,1,3148
10990,41661,52651,10990,41661,52651,1,3149
1,3,4,1,3,4,1,3150
1,1,2,1,1,2,1,3151
3,2,5,3,2,5,1,3152
1,0,1,1,0,1,1,3153
0,1,1,0,1,1,1,3154
1,3,4,1,3,4,1,3155
2,5,7,2,5,7,1,3156
8,13,21,8,13,21,1,3157
0,0,0,0,0,0,1,3158
0,7,7,0,7,7,1,3159
0,2,2,0,2,2,1,3160
2,1,3,2,1,3,1,3161
0,0,0,0,0,0,1,3162
2,4,6,2,4,6,1,3163
0,0,0,0,0,0,1,3164
0,1,1,0,1,1,1,3165
3,4,7,3,4,7,1,3166
5,1,6,5,1,6,1,3167
0,0,0,0,0,0,1,3168
0,6,6,0,6,6,1,3169
5,0,5,5,0,5,1,3170
1,0,1,1,0,1,1,3171
0,0,0,0,0,0,1,3172
24,17,41,24,17,41,1,3173
12,1,13,12,1,13,1,3174
0,1,1,0,1,1,1,3175
4,0,4,4,0,4,1,3176
16,25,41,16,25,41,1,3177
2,1,3,2,1,3,1,3178
18,14,32,18,14,32,1,3179
24,16,40,24,16,40,1,3180
2,2,4,2,2,4,1,3181
59,296,355,59,296,355,1,3182
46,175,221,46,175,221,1,3183
272,158,430,272,158,430,1,3184
19,105,124,19,105,124,1,3185
2,18,20,2,18,20,1,3186
17,67,84,17,67,84,1,3187
0,1,1,0,1,1,1,3188
11,96,107,11,96,107,1,3189
2,10,12,2,10,12,1,3190
2,2,4,2,2,4,1,3191
1,2,3,1,2,3,1,3192
26,14,40,26,14,40,1,3193
16,16,32,16,16,32,1,3194
1,1,2,1,1,2,1,3195
2,0,2,2,0,2,1,3196
2,6,8,2,6,8,1,3197
0,0,0,0,0,0,1,3198
10,17,27,10,17,27,1,3199
0,0,0,0,0,0,1,3200
7,9,16,7,9,16,1,3201
0,1,1,0,1,1,1,3202
0,0,0,0,0,0,1,3203
16,21,37,16,21,37,1,3204
79,72,151,79,72,151,1,3205
65,55,120,65,55,120,1,3206
7,17,24,7,17,24,1,3207
71,110,181,71,110,181,1,3208
6,8,14,6,8,14,1,3209
96,235,331,96,235,331,1,3210
157,307,464,157,307,464,1,3211
98,121,219,98,121,219,1,3212
6,21,27,6,21,27,1,3213
32,108,140,32,108,140,1,3214
60,9,69,60,9,69,1,3215
2,0,2,2,0,2,1,3216
5,15,20,5,15,20,1,3217
0,0,0,0,0,0,1,3218
0,2,2,0,2,2,1,3219
0,0,0,0,0,0,1,3220
7,28,35,7,28,35,1,3221
1,0,1,1,0,1,1,3222
9,20,29,9,20,29,1,3223
1,1,2,1,1,2,1,3224
3,2,5,3,2,5,1,3225
8,14,22,8,14,22,1,3226
1,0,1,1,0,1,1,3227
0,0,0,0,0,0,1,3228
0,1,1,0,1,1,1,3229
0,1,1,0,1,1,1,3230
0,4,4,0,4,4,1,3231
145,415,560,145,415,560,1,3232
1,4,5,1,4,5,1,3233
2,2,4,2,2,4,1,3234
0,0,0,0,0,0,1,3235
3,12,15,3,12,15,1,3236
1,0,1,1,0,1,1,3237
1,2,3,1,2,3,1,3238
0,9,9,0,9,9,1,3239
15,30,45,15,30,45,1,3240
2,7,9,2,7,9,1,3241
10,16,26,10,16,26,1,3242
3,7,10,3,7,10,1,3243
0,0,0,0,0,0,1,3244
2,2,4,2,2,4,1,3245
0,0,0,0,0,0,1,3246
10,1,11,10,1,11,1,3247
3,3,6,3,3,6,1,3248
2,2,4,2,2,4,1,3249
4,0,4,4,0,4,1,3250
0,5,5,0,5,5,1,3251
1,1,2,1,1,2,1,3252
1,0,1,1,0,1,1,3253
0,0,0,0,0,0,1,3254
1,0,1,1,0,1,1,3255
10,6,16,10,6,16,1,3256
12,18,30,12,18,30,1,3257
1,0,1,1,0,1,1,3258
2,9,11,2,9,11,1,3259
1,1,2,1,1,2,1,3260
0,2,2,0,2,2,1,3261
0,0,0,0,0,0,1,3262
0,4,4,0,4,4,1,3263
55,233,288,55,233,288,1,3264
1,0,1,1,0,1,1,3265
5,18,23,5,18,23,1,3266
15,10,25,15,10,25,1,3267
0,7,7,0,7,7,1,3268
87,609,696,87,609,696,1,3269
112,467,579,112,467,579,1,3270
0,0,0,0,0,0,1,3271
10,43,53,10,43,53,1,3272
21,80,101,21,80,101,1,3273
0,5,5,0,5,5,1,3274
151,217,368,151,217,368,1,3275
8,6,14,8,6,14,1,3276
7,73,80,7,73,80,1,3277
2,9,11,2,9,11,1,3278
0,0,0,0,0,0,1,3279
1,2,3,1,2,3,1,3280
2,0,2,2,0,2,1,3281
1,0,1,1,0,1,1,3282
1,0,1,1,0,1,1,3283
0,0,0,0,0,0,1,3284
2,3,5,2,3,5,1,3285
64,140,204,64,140,204,1,3286
0,0,0,0,0,0,1,3287
0,0,0,0,0,0,1,3288
2,5,7,2,5,7,1,3289
0,1,1,0,1,1,1,3290
1,0,1,1,0,1,1,3291
1,4,5,1,4,5,1,3292
0,0,0,0,0,0,1,3293
1,3,4,1,3,4,1,3294
0,0,0,0,0,0,1,3295
0,0,0,0,0,0,1,3296
6,23,29,6,23,29,1,3297
3,0,3,3,0,3,1,3298
0,1,1,0,1,1,1,3299
1,4,5,1,4,5,1,3300
2,2,4,2,2,4,1,3301
3,5,8,3,5,8,1,3302
3,7,10,3,7,10,1,3303
0,0,0,0,0,0,1,3304
2,0,2,2,0,2,1,3305
4,6,10,4,6,10,1,3306
1,5,6,1,5,6,1,3307
0,3,3,0,3,3,1,3308
1,0,1,1,0,1,1,3309
1,2,3,1,2,3,1,3310
0,0,0,0,0,0,1,3311
0,0,0,0,0,0,1,3312
27,115,142,27,115,142,1,3313
578,918,1496,578,918,1496,1,3314
24,138,162,24,138,162,1,3315
2,3,5,2,3,5,1,3316
5,6,11,5,6,11,1,3317
80,639,719,80,639,719,1,3318
0,7,7,0,7,7,1,3319
0,0,0,0,0,0,1,3320
0,2,2,0,2,2,1,3321
0,3,3,0,3,3,1,3322
3,13,16,3,13,16,1,3323
25,135,160,25,135,160,1,3324
0,10,10,0,10,10,1,3325
53,127,180,53,127,180,1,3326
83,362,445,83,362,445,1,3327
2790,16176,18966,2790,16176,18966,1,3328
2430,10771,13201,2430,10771,13201,1,3329
202,721,923,202,721,923,1,3330
64,299,363,64,299,363,1,3331
16,47,63,16,47,63,1,3332
0,0,0,0,0,0,1,3333
3,9,12,3,9,12,1,3334
283,644,927,283,644,927,1,3335
155,870,1025,155,870,1025,1,3336
11,61,72,11,61,72,1,3337
220,699,919,220,699,919,1,3338
5049,13415,18464,5049,13415,18464,1,3339
169,479,648,169,479,648,1,3340
130,398,528,130,398,528,1,3341
796,3181,3977,796,3181,3977,1,3342
1725,5824,7549,1725,5824,7549,1,3343
2915,17597,20512,2915,17597,20512,1,3344
25,243,268,25,243,268,1,3345
72,167,239,72,167,239,1,3346
0,0,0,0,0,0,1,3347
175,410,585,175,410,585,1,3348
80,148,228,80,148,228,1,3349
54,64,118,54,64,118,1,3350
33,177,210,33,177,210,1,3351
0,0,0,0,0,0,1,3352
4,0,4,4,0,4,1,3353
1,1,2,1,1,2,1,3354
2,0,2,2,0,2,1,3355
0,0,0,0,0,0,1,3356
4,1,5,4,1,5,1,3357
0,0,0,0,0,0,1,3358
1,1,2,1,1,2,1,3359
1,1,2,1,1,2,1,3360
0,0,0,0,0,0,1,3361
23,63,86,23,63,86,1,3362
8,9,17,8,9,17,1,3363
0,0,0,0,0,0,1,3364
416,227,643,416,227,643,1,3365
1,1,2,1,1,2,1,3366
3,0,3,3,0,3,1,3367
9,18,27,9,18,27,1,3368
0,0,0,0,0,0,1,3369
0,0,0,0,0,0,1,3370
0,2,2,0,2,2,1,3371
0,0,0,0,0,0,1,3372
2,1,3,2,1,3,1,3373
1,2,3,1,2,3,1,3374
1,3,4,1,3,4,1,3375
1,4,5,1,4,5,1,3376
0,1,1,0,1,1,1,3377
2,2,4,2,2,4,1,3378
0,0,0,0,0,0,1,3379
0,0,0,0,0,0,1,3380
0,0,0,0,0,0,1,3381
4,0,4,4,0,4,1,3382
0,1,1,0,1,1,1,3383
2,9,11,2,9,11,1,3384
7,32,39,7,32,39,1,3385
0,2,2,0,2,2,1,3386
1,17,18,1,17,18,1,3387
0,0,0,0,0,0,1,3388
1,16,17,1,16,17,1,3389
6,2,8,6,2,8,1,3390
4,2,6,4,2,6,1,3391
10,4,14,10,4,14,1,3392
18,4,22,18,4,22,1,3393
12,18,30,12,18,30,1,3394
5,2,7,5,2,7,1,3395
56,27,83,56,27,83,1,3396
0,0,0,0,0,0,1,3397
34,36,70,34,36,70,1,3398
0,1,1,0,1,1,1,3399
0,2,2,0,2,2,1,3400
4,2,6,4,2,6,1,3401
3,1,4,3,1,4,1,3402
2,0,2,2,0,2,1,3403
0,0,0,0,0,0,1,3404
0,3,3,0,3,3,1,3405
3,0,3,3,0,3,1,3406
20,97,117,20,97,117,1,3407
16,51,67,16,51,67,1,3408
29,76,105,29,76,105,1,3409
2,2,4,2,2,4,1,3410
4,14,18,4,14,18,1,3411
11,69,80,11,69,80,1,3412
19,48,67,19,48,67,1,3413
3,10,13,3,10,13,1,3414
20,39,59,20,39,59,1,3415
2,10,12,2,10,12,1,3416
27,90,117,27,90,117,1,3417
420,1680,2100,420,1680,2100,1,3418
14,27,41,14,27,41,1,3419
0,5,5,0,5,5,1,3420
14,37,51,14,37,51,1,3421
162,343,505,162,343,505,1,3422
11,11,22,11,11,22,1,3423
3,3,6,3,3,6,1,3424
7,7,14,7,7,14,1,3425
6,8,14,6,8,14,1,3426
56,100,156,56,100,156,1,3427
75,156,231,75,156,231,1,3428
48,101,149,48,101,149,1,3429
150,149,299,150,149,299,1,3430
997,737,1734,997,737,1734,1,3431
12,23,35,12,23,35,1,3432
7,8,15,7,8,15,1,3433
2,3,5,2,3,5,1,3434
3,7,10,3,7,10,1,3435
19,46,65,19,46,65,1,3436
80,28,108,80,28,108,1,3437
72,283,355,72,283,355,1,3438
0,0,0,0,0,0,1,3439
5,2,7,5,2,7,1,3440
2,1,3,2,1,3,1,3441
10,6,16,10,6,16,1,3442
3,2,5,3,2,5,1,3443
2692,851,3543,2692,851,3543,1,3444
109,155,264,109,155,264,1,3445
45,52,97,45,52,97,1,3446
44,151,195,44,151,195,1,3447
864,2458,3322,864,2458,3322,1,3448
397,1311,1708,397,1311,1708,1,3449
6,43,49,6,43,49,1,3450
8,67,75,8,67,75,1,3451
2,19,21,2,19,21,1,3452
17,58,75,17,58,75,1,3453
0,0,0,0,0,0,1,3454
14,0,14,14,0,14,1,3455
1,1,2,1,1,2,1,3456
2,12,14,2,12,14,1,3457
2,4,6,2,4,6,1,3458
7921,38425,46346,7921,38425,46346,1,3459
2,0,2,2,0,2,1,3460
2,1,3,2,1,3,1,3461
33,18,51,33,18,51,1,3462
15,9,24,15,9,24,1,3463
9,17,26,9,17,26,1,3464
91,124,215,91,124,215,1,3465
2,68,70,2,68,70,1,3466
0,0,0,0,0,0,1,3467
545,705,1250,545,705,1250,1,3468
67,108,175,67,108,175,1,3469
2,0,2,2,0,2,1,3470
14,12,26,14,12,26,1,3471
2,1,3,2,1,3,1,3472
0,2,2,0,2,2,1,3473
0,9,9,0,9,9,1,3474
2,9,11,2,9,11,1,3475
0,5,5,0,5,5,1,3476
0,1,1,0,1,1,1,3477
2,1,3,2,1,3,1,3478
46,73,119,46,73,119,1,3479
239,869,1108,239,869,1108,1,3480
29,45,74,29,45,74,1,3481
13,12,25,13,12,25,1,3482
3,10,13,3,10,13,1,3483
3,13,16,3,13,16,1,3484
27,78,105,27,78,105,1,3485
2,10,12,2,10,12,1,3486
3,4,7,3,4,7,1,3487
5,30,35,5,30,35,1,3488
2,2,4,2,2,4,1,3489
1,0,1,1,0,1,1,3490
1,6,7,1,6,7,1,3491
32,26,58,32,26,58,1,3492
4,4,8,4,4,8,1,3493
12,23,35,12,23,35,1,3494
4,19,23,4,19,23,1,3495
1,6,7,1,6,7,1,3496
1,7,8,1,7,8,1,3497
13,65,78,13,65,78,1,3498
5,12,17,5,12,17,1,3499
7,30,37,7,30,37,1,3500
1,1,2,1,1,2,1,3501
3,9,12,3,9,12,1,3502
0,0,0,0,0,0,1,3503
0,0,0,0,0,0,1,3504
317,777,1094,317,777,1094,1,3505
104,236,340,104,236,340,1,3506
39,108,147,39,108,147,1,3507
6,29,35,6,29,35,1,3508
0,0,0,0,0,0,1,3509
0,0,0,0,0,0,1,3510
0,0,0,0,0,0,1,3511
53,44,97,53,44,97,1,3512
764,1716,2480,764,1716,2480,1,3513
63,181,244,63,181,244,1,3514
86,285,371,86,285,371,1,3515
215,924,1139,215,924,1139,1,3516
6,4,10,6,4,10,1,3517
12,18,30,12,18,30,1,3518
0,0,0,0,0,0,1,3519
129,264,393,129,264,393,1,3520
0,0,0,0,0,0,1,3521
0,0,0,0,0,0,1,3522
1,0,1,1,0,1,1,3523
1,0,1,1,0,1,1,3524
2,1,3,2,1,3,1,3525
1,7,8,1,7,8,1,3526
2,2,4,2,2,4,1,3527
0,0,0,0,0,0,1,3528
1,0,1,1,0,1,1,3529
0,3,3,0,3,3,1,3530
0,0,0,0,0,0,1,3531
0,0,0,0,0,0,1,3532
0,0,0,0,0,0,1,3533
6,6,12,6,6,12,1,3534
0,2,2,0,2,2,1,3535
1,5,6,1,5,6,1,3536
1,2,3,1,2,3,1,3537
5,9,14,5,9,14,1,3538
7,28,35,7,28,35,1,3539
80,121,201,80,121,201,1,3540
1,4,5,1,4,5,1,3541
5,8,13,5,8,13,1,3542
9,26,35,9,26,35,1,3543
1,0,1,1,0,1,1,3544
0,0,0,0,0,0,1,3545
859,1573,2432,859,1573,2432,1,3546
33,151,184,33,151,184,1,3547
14,98,112,14,98,112,1,3548
0,0,0,0,0,0,1,3549
5,0,5,5,0,5,1,3550
17,23,40,17,23,40,1,3551
5,0,5,5,0,5,1,3552
2,1,3,2,1,3,1,3553
0,3,3,0,3,3,1,3554
0,2,2,0,2,2,1,3555
104,105,209,104,105,209,1,3556
1,3,4,1,3,4,1,3557
9,28,37,9,28,37,1,3558
2,8,10,2,8,10,1,3559
5,0,5,5,0,5,1,3560
3,1,4,3,1,4,1,3561
8,27,35,8,27,35,1,3562
8,50,58,8,50,58,1,3563
0,0,0,0,0,0,1,3564
18,52,70,18,52,70,1,3565
2,1,3,2,1,3,1,3566
6,37,43,6,37,43,1,3567
69,350,419,69,350,419,1,3568
10,22,32,10,22,32,1,3569
1,2,3,1,2,3,1,3570
1,3,4,1,3,4,1,3571
2,1,3,2,1,3,1,3572
4,5,9,4,5,9,1,3573
5,8,13,5,8,13,1,3574
0,0,0,0,0,0,1,3575
0,1,1,0,1,1,1,3576
3,2,5,3,2,5,1,3577
7,30,37,7,30,37,1,3578
204,656,860,204,656,860,1,3579
39,99,138,39,99,138,1,3580
179,267,446,179,267,446,1,3581
4604,16236,20840,4604,16236,20840,1,3582
1374,4970,6344,1374,4970,6344,1,3583
49,188,237,49,188,237,1,3584
31,92,123,31,92,123,1,3585
2129,7001,9130,2129,7001,9130,1,3586
2032,7245,9277,2032,7245,9277,1,3587
1625,7108,8733,1625,7108,8733,1,3588
4,3,7,4,3,7,1,3589
3,0,3,3,0,3,1,3590
1,1,2,1,1,2,1,3591
0,0,0,0,0,0,1,3592
5,29,34,5,29,34,1,3593
2,1,3,2,1,3,1,3594
0,2,2,0,2,2,1,3595
1,0,1,1,0,1,1,3596
2,2,4,2,2,4,1,3597
0,1,1,0,1,1,1,3598
0,0,0,0,0,0,1,3599
1,2,3,1,2,3,1,3600
23,36,59,23,36,59,1,3601
0,0,0,0,0,0,1,3602
30,84,114,30,84,114,1,3603
28,46,74,28,46,74,1,3604
1762,15642,17404,1762,15642,17404,1,3605
15374,45385,60759,15374,45385,60759,1,3606
57,188,245,57,188,245,1,3607
89,383,472,89,383,472,1,3608
21,132,153,21,132,153,1,3609
239,1047,1286,239,1047,1286,1,3610
585,1724,2309,585,1724,2309,1,3611
339,930,1269,339,930,1269,1,3612
18,58,76,18,58,76,1,3613
26,102,128,26,102,128,1,3614
855,3478,4333,855,3478,4333,1,3615
4,1,5,4,1,5,1,3616
3,3,6,3,3,6,1,3617
236,101,337,236,101,337,1,3618
50,31,81,50,31,81,1,3619
2,13,15,2,13,15,1,3620
0,17,17,0,17,17,1,3621
3,7,10,3,7,10,1,3622
2,9,11,2,9,11,1,3623
394,678,1072,394,678,1072,1,3624
375,1044,1419,375,1044,1419,1,3625
0,10,10,0,10,10,1,3626
68,25,93,68,25,93,1,3627
37,42,79,37,42,79,1,3628
197,54,251,197,54,251,1,3629
0,0,0,0,0,0,1,3630
60,16,76,60,16,76,1,3631
12,0,12,12,0,12,1,3632
2,1,3,2,1,3,1,3633
5,7,12,5,7,12,1,3634
5,21,26,5,21,26,1,3635
0,3,3,0,3,3,1,3636
1,0,1,1,0,1,1,3637
0,0,0,0,0,0,1,3638
0,2,2,0,2,2,1,3639
1,3,4,1,3,4,1,3640
0,2,2,0,2,2,1,3641
0,2,2,0,2,2,1,3642
5,3,8,5,3,8,1,3643
0,0,0,0,0,0,1,3644
4,1,5,4,1,5,1,3645
1,0,1,1,0,1,1,3646
1,1,2,1,1,2,1,3647
2,6,8,2,6,8,1,3648
0,0,0,0,0,0,1,3649
1,6,7,1,6,7,1,3650
0,1,1,0,1,1,1,3651
2,6,8,2,6,8,1,3652
6,21,27,6,21,27,1,3653
3,1,4,3,1,4,1,3654
0,0,0,0,0,0,1,3655
0,2,2,0,2,2,1,3656
2,5,7,2,5,7,1,3657
0,0,0,0,0,0,1,3658
9,12,21,9,12,21,1,3659
21,50,71,21,50,71,1,3660
26,63,89,26,63,89,1,3661
18,31,49,18,31,49,1,3662
53,120,173,53,120,173,1,3663
1,8,9,1,8,9,1,3664
2,26,28,2,26,28,1,3665
6,25,31,6,25,31,1,3666
0,0,0,0,0,0,1,3667
0,0,0,0,0,0,1,3668
1,1,2,1,1,2,1,3669
62,137,199,62,137,199,1,3670
452,2005,2457,452,2005,2457,1,3671
24,19,43,24,19,43,1,3672
8,7,15,8,7,15,1,3673
2,0,2,2,0,2,1,3674
39,162,201,39,162,201,1,3675
9,13,22,9,13,22,1,3676
12,56,68,12,56,68,1,3677
10,27,37,10,27,37,1,3678
1,4,5,1,4,5,1,3679
0,0,0,0,0,0,1,3680
3,17,20,3,17,20,1,3681
0,1,1,0,1,1,1,3682
0,0,0,0,0,0,1,3683
1,1,2,1,1,2,1,3684
0,0,0,0,0,0,1,3685
0,0,0,0,0,0,1,3686
458,1543,2001,458,1543,2001,1,3687
850,2796,3646,850,2796,3646,1,3688
108,202,310,108,202,310,1,3689
150,342,492,150,342,492,1,3690
163,197,360,163,197,360,1,3691
432,2360,2792,432,2360,2792,1,3692
4,12,16,4,12,16,1,3693
2,11,13,2,11,13,1,3694
1,1,2,1,1,2,1,3695
1,0,1,1,0,1,1,3696
0,0,0,0,0,0,1,3697
1,0,1,1,0,1,1,3698
0,0,0,0,0,0,1,3699
0,0,0,0,0,0,1,3700
4,7,11,4,7,11,1,3701
2,3,5,2,3,5,1,3702
15,11,26,15,11,26,1,3703
77,147,224,77,147,224,1,3704
4,2,6,4,2,6,1,3705
4,5,9,4,5,9,1,3706
24,17,41,24,17,41,1,3707
85,164,249,85,164,249,1,3708
0,1,1,0,1,1,1,3709
378,1494,1872,378,1494,1872,1,3710
9,7,16,9,7,16,1,3711
7,3,10,7,3,10,1,3712
127,378,505,127,378,505,1,3713
4,27,31,4,27,31,1,3714
130,363,493,130,363,493,1,3715
16,5,21,16,5,21,1,3716
7,2,9,7,2,9,1,3717
0,0,0,0,0,0,1,3718
361,1271,1632,361,1271,1632,1,3719
29,115,144,29,115,144,1,3720
30,166,196,30,166,196,1,3721
6,34,40,6,34,40,1,3722
21,77,98,21,77,98,1,3723
0,1,1,0,1,1,1,3724
1,0,1,1,0,1,1,3725
0,0,0,0,0,0,1,3726
43,25,68,43,25,68,1,3727
33,48,81,33,48,81,1,3728
130,1323,1453,130,1323,1453,1,3729
6,11,17,6,11,17,1,3730
4,1,5,4,1,5,1,3731
15,18,33,15,18,33,1,3732
11,12,23,11,12,23,1,3733
2,19,21,2,19,21,1,3734
0,3,3,0,3,3,1,3735
0,1,1,0,1,1,1,3736
3,7,10,3,7,10,1,3737
0,1,1,0,1,1,1,3738
1,0,1,1,0,1,1,3739
0,0,0,0,0,0,1,3740
2,9,11,2,9,11,1,3741
0,0,0,0,0,0,1,3742
1,0,1,1,0,1,1,3743
1,0,1,1,0,1,1,3744
160,411,571,160,411,571,1,3745
194,613,807,194,613,807,1,3746
6,5,11,6,5,11,1,3747
449,1580,2029,449,1580,2029,1,3748
1,0,1,1,0,1,1,3749
1,5,6,1,5,6,1,3750
3,10,13,3,10,13,1,3751
9,3,12,9,3,12,1,3752
0,10,10,0,10,10,1,3753
0,2,2,0,2,2,1,3754
0,3,3,0,3,3,1,3755
0,0,0,0,0,0,1,3756
0,0,0,0,0,0,1,3757
0,0,0,0,0,0,1,3758
0,1,1,0,1,1,1,3759
0,0,0,0,0,0,1,3760
7,12,19,7,12,19,1,3761
0,0,0,0,0,0,1,3762
0,3,3,0,3,3,1,3763
15,44,59,15,44,59,1,3764
7,2,9,7,2,9,1,3765
1,0,1,1,0,1,1,3766
0,1,1,0,1,1,1,3767
2,0,2,2,0,2,1,3768
5,15,20,5,15,20,1,3769
0,0,0,0,0,0,1,3770
0,1,1,0,1,1,1,3771
0,0,0,0,0,0,1,3772
0,0,0,0,0,0,1,3773
29,46,75,29,46,75,1,3774
24,14,38,24,14,38,1,3775
0,0,0,0,0,0,1,3776
0,0,0,0,0,0,1,3777
0,0,0,0,0,0,1,3778
0,0,0,0,0,0,1,3779
22,17,39,22,17,39,1,3780
0,0,0,0,0,0,1,3781
2,0,2,2,0,2,1,3782
5,4,9,5,4,9,1,3783
431,152,583,431,152,583,1,3784
0,0,0,0,0,0,1,3785
0,1,1,0,1,1,1,3786
69,18,87,69,18,87,1,3787
14,9,23,14,9,23,1,3788
5,3,8,5,3,8,1,3789
1,1,2,1,1,2,1,3790
0,0,0,0,0,0,1,3791
0,0,0,0,0,0,1,3792
0,0,0,0,0,0,1,3793
5,2,7,5,2,7,1,3794
0,0,0,0,0,0,1,3795
1,0,1,1,0,1,1,3796
1,0,1,1,0,1,1,3797
0,0,0,0,0,0,1,3798
1,3,4,1,3,4,1,3799
1,0,1,1,0,1,1,3800
1,0,1,1,0,1,1,3801
0,0,0,0,0,0,1,3802
0,0,0,0,0,0,1,3803
0,0,0,0,0,0,1,3804
1,0,1,1,0,1,1,3805
1,0,1,1,0,1,1,3806
3,22,25,3,22,25,1,3807
0,0,0,0,0,0,1,3808
1,4,5,1,4,5,1,3809
0,2,2,0,2,2,1,3810
3,2,5,3,2,5,1,3811
0,0,0,0,0,0,1,3812
0,0,0,0,0,0,1,3813
0,0,0,0,0,0,1,3814
1,10,11,1,10,11,1,3815
0,0,0,0,0,0,1,3816
0,0,0,0,0,0,1,3817
0,0,0,0,0,0,1,3818
0,0,0,0,0,0,1,3819
0,0,0,0,0,0,1,3820
0,0,0,0,0,0,1,3821
0,0,0,0,0,0,1,3822
0,0,0,0,0,0,1,3823
0,0,0,0,0,0,1,3824
0,2,2,0,2,2,1,3825
0,1,1,0,1,1,1,3826
0,3,3,0,3,3,1,3827
25,110,135,25,110,135,1,3828
38,63,101,38,63,101,1,3829
7,10,17,7,10,17,1,3830
6,9,15,6,9,15,1,3831
7,28,35,7,28,35,1,3832
0,3,3,0,3,3,1,3833
9,5,14,9,5,14,1,3834
0,0,0,0,0,0,1,3835
107,299,406,107,299,406,1,3836
2,5,7,2,5,7,1,3837
4,5,9,4,5,9,1,3838
0,0,0,0,0,0,1,3839
0,5,5,0,5,5,1,3840
2,1,3,2,1,3,1,3841
759,3685,4444,759,3685,4444,1,3842
38,85,123,38,85,123,1,3843
2,1,3,2,1,3,1,3844
0,0,0,0,0,0,1,3845
0,0,0,0,0,0,1,3846
0,0,0,0,0,0,1,3847
2,3,5,2,3,5,1,3848
0,0,0,0,0,0,1,3849
0,0,0,0,0,0,1,3850
1,0,1,1,0,1,1,3851
0,0,0,0,0,0,1,3852
1,0,1,1,0,1,1,3853
0,0,0,0,0,0,1,3854
3,12,15,3,12,15,1,3855
2,0,2,2,0,2,1,3856
0,1,1,0,1,1,1,3857
1,0,1,1,0,1,1,3858
0,0,0,0,0,0,1,3859
13,8,21,13,8,21,1,3860
0,2,2,0,2,2,1,3861
1,4,5,1,4,5,1,3862
3,2,5,3,2,5,1,3863
10,1,11,10,1,11,1,3864
0,0,0,0,0,0,1,3865
78,36,114,78,36,114,1,3866
42,115,157,42,115,157,1,3867
2,5,7,2,5,7,1,3868
0,2,2,0,2,2,1,3869
3,2,5,3,2,5,1,3870
0,0,0,0,0,0,1,3871
1,1,2,1,1,2,1,3872
0,6,6,0,6,6,1,3873
4,2,6,4,2,6,1,3874
6,6,12,6,6,12,1,3875
2,2,4,2,2,4,1,3876
1,1,2,1,1,2,1,3877
0,1,1,0,1,1,1,3878
0,0,0,0,0,0,1,3879
3,5,8,3,5,8,1,3880
1,6,7,1,6,7,1,3881
0,1,1,0,1,1,1,3882
0,1,1,0,1,1,1,3883
1,1,2,1,1,2,1,3884
0,0,0,0,0,0,1,3885
0,4,4,0,4,4,1,3886
1,1,2,1,1,2,1,3887
28,15,43,28,15,43,1,3888
2,1,3,2,1,3,1,3889
9,7,16,9,7,16,1,3890
3,9,12,3,9,12,1,3891
0,0,0,0,0,0,1,3892
1,1,2,1,1,2,1,3893
1,2,3,1,2,3,1,3894
0,0,0,0,0,0,1,3895
3,17,20,3,17,20,1,3896
0,0,0,0,0,0,1,3897
3,7,10,3,7,10,1,3898
1,3,4,1,3,4,1,3899
2,1,3,2,1,3,1,3900
5,1,6,5,1,6,1,3901
6,1,7,6,1,7,1,3902
11,39,50,11,39,50,1,3903
2,12,14,2,12,14,1,3904
0,0,0,0,0,0,1,3905
0,2,2,0,2,2,1,3906
0,0,0,0,0,0,1,3907
0,0,0,0,0,0,1,3908
0,0,0,0,0,0,1,3909
4,4,8,4,4,8,1,3910
0,2,2,0,2,2,1,3911
6,4,10,6,4,10,1,3912
5,1,6,5,1,6,1,3913
2,2,4,2,2,4,1,3914
3,1,4,3,1,4,1,3915
2,0,2,2,0,2,1,3916
0,0,0,0,0,0,1,3917
0,0,0,0,0,0,1,3918
0,0,0,0,0,0,1,3919
0,0,0,0,0,0,1,3920
10,52,62,10,52,62,1,3921
9,14,23,9,14,23,1,3922
0,0,0,0,0,0,1,3923
1,0,1,1,0,1,1,3924
0,0,0,0,0,0,1,3925
0,0,0,0,0,0,1,3926
14,9,23,14,9,23,1,3927
6,6,12,6,6,12,1,3928
1,3,4,1,3,4,1,3929
0,0,0,0,0,0,1,3930
0,0,0,0,0,0,1,3931
1,1,2,1,1,2,1,3932
103,283,386,103,283,386,1,3933
1,3,4,1,3,4,1,3934
1,0,1,1,0,1,1,3935
1,2,3,1,2,3,1,3936
0,1,1,0,1,1,1,3937
0,0,0,0,0,0,1,3938
1,0,1,1,0,1,1,3939
1,0,1,1,0,1,1,3940
1,0,1,1,0,1,1,3941
11,26,37,11,26,37,1,3942
0,0,0,0,0,0,1,3943
0,0,0,0,0,0,1,3944
4,0,4,4,0,4,1,3945
1,4,5,1,4,5,1,3946
0,0,0,0,0,0,1,3947
1,0,1,1,0,1,1,3948
0,1,1,0,1,1,1,3949
3,0,3,3,0,3,1,3950
54,167,221,54,167,221,1,3951
0,0,0,0,0,0,1,3952
1,1,2,1,1,2,1,3953
1,0,1,1,0,1,1,3954
1,1,2,1,1,2,1,3955
1,5,6,1,5,6,1,3956
0,0,0,0,0,0,1,3957
0,0,0,0,0,0,1,3958
8,31,39,8,31,39,1,3959
3,5,8,3,5,8,1,3960
1,0,1,1,0,1,1,3961
6,3,9,6,3,9,1,3962
0,0,0,0,0,0,1,3963
0,0,0,0,0,0,1,3964
6,4,10,6,4,10,1,3965
0,0,0,0,0,0,1,3966
0,0,0,0,0,0,1,3967
1,2,3,1,2,3,1,3968
4,0,4,4,0,4,1,3969
13,7,20,13,7,20,1,3970
8,2,10,8,2,10,1,3971
1,0,1,1,0,1,1,3972
0,0,0,0,0,0,1,3973
1,0,1,1,0,1,1,3974
2,0,2,2,0,2,1,3975
2,0,2,2,0,2,1,3976
2,1,3,2,1,3,1,3977
8,2,10,8,2,10,1,3978
0,0,0,0,0,0,1,3979
0,0,0,0,0,0,1,3980
0,0,0,0,0,0,1,3981
1,2,3,1,2,3,1,3982
0,0,0,0,0,0,1,3983
0,1,1,0,1,1,1,3984
1,1,2,1,1,2,1,3985
0,0,0,0,0,0,1,3986
0,0,0,0,0,0,1,3987
0,0,0,0,0,0,1,3988
6,57,63,6,57,63,1,3989
3,1,4,3,1,4,1,3990
0,0,0,0,0,0,1,3991
3,0,3,3,0,3,1,3992
0,0,0,0,0,0,1,3993
0,0,0,0,0,0,1,3994
6,0,6,6,0,6,1,3995
12,66,78,12,66,78,1,3996
2,23,25,2,23,25,1,3997
0,2,2,0,2,2,1,3998
0,0,0,0,0,0,1,3999
3,0,3,3,0,3,1,4000
2,0,2,2,0,2,1,4001
2,6,8,2,6,8,1,4002
0,0,0,0,0,0,1,4003
1,0,1,1,0,1,1,4004
0,0,0,0,0,0,1,4005
0,1,1,0,1,1,1,4006
88,258,346,88,258,346,1,4007
1,0,1,1,0,1,1,4008
1,4,5,1,4,5,1,4009
1,2,3,1,2,3,1,4010
0,0,0,0,0,0,1,4011
1,0,1,1,0,1,1,4012
1,2,3,1,2,3,1,4013
0,1,1,0,1,1,1,4014
0,0,0,0,0,0,1,4015
1,0,1,1,0,1,1,4016
0,0,0,0,0,0,1,4017
27,39,66,27,39,66,1,4018
16,45,61,16,45,61,1,4019
2,8,10,2,8,10,1,4020
3,1,4,3,1,4,1,4021
1,3,4,1,3,4,1,4022
7,23,30,7,23,30,1,4023
0,0,0,0,0,0,1,4024
1,1,2,1,1,2,1,4025
0,0,0,0,0,0,1,4026
0,7,7,0,7,7,1,4027
3,0,3,3,0,3,1,4028
1,1,2,1,1,2,1,4029
0,0,0,0,0,0,1,4030
0,1,1,0,1,1,1,4031
1,0,1,1,0,1,1,4032
0,0,0,0,0,0,1,4033
5,2,7,5,2,7,1,4034
21,112,133,21,112,133,1,4035
0,0,0,0,0,0,1,4036
0,0,0,0,0,0,1,4037
0,0,0,0,0,0,1,4038
0,0,0,0,0,0,1,4039
0,0,0,0,0,0,1,4040
0,0,0,0,0,0,1,4041
0,3,3,0,3,3,1,4042
1,0,1,1,0,1,1,4043
4,13,17,4,13,17,1,4044
0,0,0,0,0,0,1,4045
3,7,10,3,7,10,1,4046
7,11,18,7,11,18,1,4047
0,0,0,0,0,0,1,4048
4,0,4,4,0,4,1,4049
0,2,2,0,2,2,1,4050
27,5,32,27,5,32,1,4051
0,0,0,0,0,0,1,4052
1,0,1,1,0,1,1,4053
1,0,1,1,0,1,1,4054
0,0,0,0,0,0,1,4055
0,1,1,0,1,1,1,4056
0,0,0,0,0,0,1,4057
0,0,0,0,0,0,1,4058
1,1,2,1,1,2,1,4059
57,60,117,57,60,117,1,4060
5220,5896,11116,5220,5896,11116,1,4061
621,1790,2411,621,1790,2411,1,4062
0,0,0,0,0,0,1,4063
0,0,0,0,0,0,1,4064
0,0,0,0,0,0,1,4065
0,0,0,0,0,0,1,4066
3,2,5,3,2,5,1,4067
45,24,69,45,24,69,1,4068
0,0,0,0,0,0,1,4069
1,1,2,1,1,2,1,4070
0,0,0,0,0,0,1,4071
602,2073,2675,602,2073,2675,1,4072
0,1,1,0,1,1,1,4073
121,114,235,121,114,235,1,4074
56,38,94,56,38,94,1,4075
1,4,5,1,4,5,1,4076
353,278,631,353,278,631,1,4077
0,0,0,0,0,0,1,4078
0,0,0,0,0,0,1,4079
4,6,10,4,6,10,1,4080
2,2,4,2,2,4,1,4081
3,2,5,3,2,5,1,4082
2,6,8,2,6,8,1,4083
0,0,0,0,0,0,1,4084
10,4,14,10,4,14,1,4085
7,2,9,7,2,9,1,4086
42,121,163,42,121,163,1,4087
5,40,45,5,40,45,1,4088
0,0,0,0,0,0,1,4089
9,5,14,9,5,14,1,4090
9,1,10,9,1,10,1,4091
5,1,6,5,1,6,1,4092
0,0,0,0,0,0,1,4093
0,0,0,0,0,0,1,4094
6,18,24,6,18,24,1,4095
13,41,54,13,41,54,1,4096
0,0,0,0,0,0,1,4097
1,2,3,1,2,3,1,4098
3,1,4,3,1,4,1,4099
2,0,2,2,0,2,1,4100
0,0,0,0,0,0,1,4101
0,1,1,0,1,1,1,4102
0,0,0,0,0,0,1,4103
0,0,0,0,0,0,1,4104
0,0,0,0,0,0,1,4105
0,0,0,0,0,0,1,4106
0,0,0,0,0,0,1,4107
0,0,0,0,0,0,1,4108
0,1,1,0,1,1,1,4109
2,1,3,2,1,3,1,4110
0,2,2,0,2,2,1,4111
0,0,0,0,0,0,1,4112
0,0,0,0,0,0,1,4113
3,2,5,3,2,5,1,4114
0,0,0,0,0,0,1,4115
0,0,0,0,0,0,1,4116
5,10,15,5,10,15,1,4117
0,0,0,0,0,0,1,4118
1,1,2,1,1,2,1,4119
3,4,7,3,4,7,1,4120
0,0,0,0,0,0,1,4121
2,1,3,2,1,3,1,4122
0,1,1,0,1,1,1,4123
1,1,2,1,1,2,1,4124
0,0,0,0,0,0,1,4125
2,1,3,2,1,3,1,4126
0,0,0,0,0,0,1,4127
0,0,0,0,0,0,1,4128
1,0,1,1,0,1,1,4129
0,0,0,0,0,0,1,4130
0,0,0,0,0,0,1,4131
0,0,0,0,0,0,1,4132
0,0,0,0,0,0,1,4133
2,3,5,2,3,5,1,4134
1,0,1,1,0,1,1,4135
0,0,0,0,0,0,1,4136
1,0,1,1,0,1,1,4137
17,43,60,17,43,60,1,4138
0,0,0,0,0,0,1,4139
0,0,0,0,0,0,1,4140
1,0,1,1,0,1,1,4141
0,0,0,0,0,0,1,4142
0,0,0,0,0,0,1,4143
3,1,4,3,1,4,1,4144
20,54,74,20,54,74,1,4145
3,11,14,3,11,14,1,4146
0,0,0,0,0,0,1,4147
0,0,0,0,0,0,1,4148
0,0,0,0,0,0,1,4149
1,2,3,1,2,3,1,4150
0,0,0,0,0,0,1,4151
2,0,2,2,0,2,1,4152
9,9,18,9,9,18,1,4153
0,0,0,0,0,0,1,4154
0,0,0,0,0,0,1,4155
0,0,0,0,0,0,1,4156
0,0,0,0,0,0,1,4157
1,0,1,1,0,1,1,4158
4,8,12,4,8,12,1,4159
1,2,3,1,2,3,1,4160
63,296,359,63,296,359,1,4161
3,3,6,3,3,6,1,4162
0,0,0,0,0,0,1,4163
0,0,0,0,0,0,1,4164
1,0,1,1,0,1,1,4165
20,5,25,20,5,25,1,4166
0,0,0,0,0,0,1,4167
0,0,0,0,0,0,1,4168
0,0,0,0,0,0,1,4169
0,0,0,0,0,0,1,4170
1,0,1,1,0,1,1,4171
0,0,0,0,0,0,1,4172
0,0,0,0,0,0,1,4173
0,0,0,0,0,0,1,4174
0,1,1,0,1,1,1,4175
0,0,0,0,0,0,1,4176
0,0,0,0,0,0,1,4177
0,0,0,0,0,0,1,4178
0,0,0,0,0,0,1,4179
0,0,0,0,0,0,1,4180
0,0,0,0,0,0,1,4181
2,2,4,2,2,4,1,4182
5,2,7,5,2,7,1,4183
0,0,0,0,0,0,1,4184
0,1,1,0,1,1,1,4185
13,29,42,13,29,42,1,4186
0,1,1,0,1,1,1,4187
3,0,3,3,0,3,1,4188
1,0,1,1,0,1,1,4189
3,0,3,3,0,3,1,4190
0,0,0,0,0,0,1,4191
0,0,0,0,0,0,1,4192
0,1,1,0,1,1,1,4193
3,0,3,3,0,3,1,4194
3,1,4,3,1,4,1,4195
9,19,28,9,19,28,1,4196
0,0,0,0,0,0,1,4197
1,0,1,1,0,1,1,4198
147,445,592,147,445,592,1,4199
2,0,2,2,0,2,1,4200
0,0,0,0,0,0,1,4201
0,0,0,0,0,0,1,4202
0,0,0,0,0,0,1,4203
0,0,0,0,0,0,1,4204
0,0,0,0,0,0,1,4205
0,0,0,0,0,0,1,4206
2,0,2,2,0,2,1,4207
0,0,0,0,0,0,1,4208
0,1,1,0,1,1,1,4209
0,1,1,0,1,1,1,4210
0,0,0,0,0,0,1,4211
0,0,0,0,0,0,1,4212
0,2,2,0,2,2,1,4213
0,0,0,0,0,0,1,4214
1,0,1,1,0,1,1,4215
0,0,0,0,0,0,1,4216
3,4,7,3,4,7,1,4217
0,4,4,0,4,4,1,4218
4,11,15,4,11,15,1,4219
4,8,12,4,8,12,1,4220
3,2,5,3,2,5,1,4221
0,0,0,0,0,0,1,4222
12,133,145,12,133,145,1,4223
0,1,1,0,1,1,1,4224
4,4,8,4,4,8,1,4225
1,2,3,1,2,3,1,4226
0,4,4,0,4,4,1,4227
16,8,24,16,8,24,1,4228
0,0,0,0,0,0,1,4229
5,4,9,5,4,9,1,4230
17,25,42,17,25,42,1,4231
2,0,2,2,0,2,1,4232
0,0,0,0,0,0,1,4233
0,0,0,0,0,0,1,4234
72,311,383,72,311,383,1,4235
0,3,3,0,3,3,1,4236
0,0,0,0,0,0,1,4237
0,0,0,0,0,0,1,4238
0,0,0,0,0,0,1,4239
1,1,2,1,1,2,1,4240
2,0,2,2,0,2,1,4241
4,0,4,4,0,4,1,4242
4,1,5,4,1,5,1,4243
3,1,4,3,1,4,1,4244
6,26,32,6,26,32,1,4245
72,163,235,72,163,235,1,4246
1,2,3,1,2,3,1,4247
17,14,31,17,14,31,1,4248
1,0,1,1,0,1,1,4249
1,0,1,1,0,1,1,4250
0,0,0,0,0,0,1,4251
1,0,1,1,0,1,1,4252
0,0,0,0,0,0,1,4253
0,0,0,0,0,0,1,4254
0,0,0,0,0,0,1,4255
1,0,1,1,0,1,1,4256
12,3,15,12,3,15,1,4257
0,0,0,0,0,0,1,4258
0,0,0,0,0,0,1,4259
0,1,1,0,1,1,1,4260
3,0,3,3,0,3,1,4261
7,3,10,7,3,10,1,4262
7,4,11,7,4,11,1,4263
0,4,4,0,4,4,1,4264
96,588,684,96,588,684,1,4265
0,0,0,0,0,0,1,4266
0,0,0,0,0,0,1,4267
0,0,0,0,0,0,1,4268
8,2,10,8,2,10,1,4269
0,1,1,0,1,1,1,4270
2,1,3,2,1,3,1,4271
56,65,121,56,65,121,1,4272
5,19,24,5,19,24,1,4273
5,0,5,5,0,5,1,4274
0,1,1,0,1,1,1,4275
0,0,0,0,0,0,1,4276
0,1,1,0,1,1,1,4277
0,0,0,0,0,0,1,4278
3,9,12,3,9,12,1,4279
1,1,2,1,1,2,1,4280
0,2,2,0,2,2,1,4281
0,0,0,0,0,0,1,4282
0,0,0,0,0,0,1,4283
14,28,42,14,28,42,1,4284
1,0,1,1,0,1,1,4285
4,1,5,4,1,5,1,4286
0,0,0,0,0,0,1,4287
0,0,0,0,0,0,1,4288
0,0,0,0,0,0,1,4289
0,0,0,0,0,0,1,4290
6,9,15,6,9,15,1,4291
0,1,1,0,1,1,1,4292
50,26,76,50,26,76,1,4293
5,0,5,5,0,5,1,4294
13,44,57,13,44,57,1,4295
5,0,5,5,0,5,1,4296
3,3,6,3,3,6,1,4297
0,1,1,0,1,1,1,4298
273,48,321,273,48,321,1,4299
1,0,1,1,0,1,1,4300
2,25,27,2,25,27,1,4301
1,0,1,1,0,1,1,4302
1,6,7,1,6,7,1,4303
70,129,199,70,129,199,1,4304
7,32,39,7,32,39,1,4305
10,4,14,10,4,14,1,4306
0,0,0,0,0,0,1,4307
0,1,1,0,1,1,1,4308
6,5,11,6,5,11,1,4309
1,5,6,1,5,6,1,4310
1,3,4,1,3,4,1,4311
4,9,13,4,9,13,1,4312
0,1,1,0,1,1,1,4313
1,0,1,1,0,1,1,4314
189,147,336,189,147,336,1,4315
1,2,3,1,2,3,1,4316
13,8,21,13,8,21,1,4317
4,11,15,4,11,15,1,4318
0,0,0,0,0,0,1,4319
0,0,0,0,0,0,1,4320
6,1,7,6,1,7,1,4321
3,6,9,3,6,9,1,4322
7,1,8,7,1,8,1,4323
3,4,7,3,4,7,1,4324
9,10,19,9,10,19,1,4325
1,8,9,1,8,9,1,4326
7,7,14,7,7,14,1,4327
1,0,1,1,0,1,1,4328
18,73,91,18,73,91,1,4329
0,0,0,0,0,0,1,4330
4,12,16,4,12,16,1,4331
1,6,7,1,6,7,1,4332
5,16,21,5,16,21,1,4333
0,0,0,0,0,0,1,4334
0,0,0,0,0,0,1,4335
1,1,2,1,1,2,1,4336
6,0,6,6,0,6,1,4337
2,0,2,2,0,2,1,4338
1,0,1,1,0,1,1,4339
0,2,2,0,2,2,1,4340
19,15,34,19,15,34,1,4341
0,0,0,0,0,0,1,4342
4,0,4,4,0,4,1,4343
0,0,0,0,0,0,1,4344
1,0,1,1,0,1,1,4345
1,0,1,1,0,1,1,4346
0,0,0,0,0,0,1,4347
0,0,0,0,0,0,1,4348
0,0,0,0,0,0,1,4349
445,568,1013,445,568,1013,1,4350
0,0,0,0,0,0,1,4351
3,2,5,3,2,5,1,4352
3,4,7,3,4,7,1,4353
1,0,1,1,0,1,1,4354
0,0,0,0,0,0,1,4355
3,5,8,3,5,8,1,4356
4,14,18,4,14,18,1,4357
0,3,3,0,3,3,1,4358
5,1,6,5,1,6,1,4359
8,16,24,8,16,24,1,4360
1,1,2,1,1,2,1,4361
1,1,2,1,1,2,1,4362
0,1,1,0,1,1,1,4363
0,1,1,0,1,1,1,4364
0,1,1,0,1,1,1,4365
0,0,0,0,0,0,1,4366
0,0,0,0,0,0,1,4367
0,0,0,0,0,0,1,4368
0,0,0,0,0,0,1,4369
0,0,0,0,0,0,1,4370
0,0,0,0,0,0,1,4371
0,0,0,0,0,0,1,4372
0,0,0,0,0,0,1,4373
1,0,1,1,0,1,1,4374
2,0,2,2,0,2,1,4375
0,0,0,0,0,0,1,4376
1,2,3,1,2,3,1,4377
3,0,3,3,0,3,1,4378
6,1,7,6,1,7,1,4379
3,1,4,3,1,4,1,4380
0,0,0,0,0,0,1,4381
0,6,6,0,6,6,1,4382
1,0,1,1,0,1,1,4383
5,12,17,5,12,17,1,4384
9,3,12,9,3,12,1,4385
12,5,17,12,5,17,1,4386
0,0,0,0,0,0,1,4387
0,0,0,0,0,0,1,4388
7,5,12,7,5,12,1,4389
2,7,9,2,7,9,1,4390
6,17,23,6,17,23,1,4391
7,36,43,7,36,43,1,4392
1,0,1,1,0,1,1,4393
2,1,3,2,1,3,1,4394
0,1,1,0,1,1,1,4395
0,0,0,0,0,0,1,4396
4,4,8,4,4,8,1,4397
0,0,0,0,0,0,1,4398
3,16,19,3,16,19,1,4399
12,22,34,12,22,34,1,4400
0,0,0,0,0,0,1,4401
2,2,4,2,2,4,1,4402
2,0,2,2,0,2,1,4403
16,3,19,16,3,19,1,4404
84,386,470,84,386,470,1,4405
76,241,317,76,241,317,1,4406
15,3,18,15,3,18,1,4407
15,20,35,15,20,35,1,4408
3,5,8,3,5,8,1,4409
4,0,4,4,0,4,1,4410
0,0,0,0,0,0,1,4411
0,0,0,0,0,0,1,4412
1,2,3,1,2,3,1,4413
0,0,0,0,0,0,1,4414
0,9,9,0,9,9,1,4415
1,1,2,1,1,2,1,4416
0,1,1,0,1,1,1,4417
0,0,0,0,0,0,1,4418
1,1,2,1,1,2,1,4419
0,0,0,0,0,0,1,4420
0,1,1,0,1,1,1,4421
10,35,45,10,35,45,1,4422
3,1,4,3,1,4,1,4423
1,1,2,1,1,2,1,4424
0,7,7,0,7,7,1,4425
6,2,8,6,2,8,1,4426
3,1,4,3,1,4,1,4427
0,0,0,0,0,0,1,4428
0,1,1,0,1,1,1,4429
0,0,0,0,0,0,1,4430
2,1,3,2,1,3,1,4431
10,0,10,10,0,10,1,4432
2,1,3,2,1,3,1,4433
7,1,8,7,1,8,1,4434
2,3,5,2,3,5,1,4435
3,1,4,3,1,4,1,4436
0,0,0,0,0,0,1,4437
4,4,8,4,4,8,1,4438
3,0,3,3,0,3,1,4439
1,2,3,1,2,3,1,4440
3,2,5,3,2,5,1,4441
8,9,17,8,9,17,1,4442
2,0,2,2,0,2,1,4443
0,0,0,0,0,0,1,4444
0,1,1,0,1,1,1,4445
1,0,1,1,0,1,1,4446
0,0,0,0,0,0,1,4447
1,1,2,1,1,2,1,4448
0,0,0,0,0,0,1,4449
0,2,2,0,2,2,1,4450
0,0,0,0,0,0,1,4451
3,0,3,3,0,3,1,4452
1684,1731,3415,1684,1731,3415,1,4453
1349,917,2266,1349,917,2266,1,4454
4,1,5,4,1,5,1,4455
5,1,6,5,1,6,1,4456
2,25,27,2,25,27,1,4457
0,2,2,0,2,2,1,4458
2,0,2,2,0,2,1,4459
8,1,9,8,1,9,1,4460
8,9,17,8,9,17,1,4461
6,2,8,6,2,8,1,4462
0,0,0,0,0,0,1,4463
0,0,0,0,0,0,1,4464
4,3,7,4,3,7,1,4465
4,0,4,4,0,4,1,4466
2,1,3,2,1,3,1,4467
2,0,2,2,0,2,1,4468
2,0,2,2,0,2,1,4469
0,0,0,0,0,0,1,4470
1,0,1,1,0,1,1,4471
2,0,2,2,0,2,1,4472
4,3,7,4,3,7,1,4473
0,0,0,0,0,0,1,4474
17191,12065,29256,17191,12065,29256,1,4475
0,0,0,0,0,0,1,4476
0,2,2,0,2,2,1,4477
1,1,2,1,1,2,1,4478
28,7,35,28,7,35,1,4479
8,2,10,8,2,10,1,4480
13,8,21,13,8,21,1,4481
1,0,1,1,0,1,1,4482
0,0,0,0,0,0,1,4483
0,1,1,0,1,1,1,4484
5,1,6,5,1,6,1,4485
0,0,0,0,0,0,1,4486
2,1,3,2,1,3,1,4487
7,39,46,7,39,46,1,4488
2,0,2,2,0,2,1,4489
4,2,6,4,2,6,1,4490
2,1,3,2,1,3,1,4491
0,0,0,0,0,0,1,4492
14,8,22,14,8,22,1,4493
12,11,23,12,11,23,1,4494
2,2,4,2,2,4,1,4495
0,4,4,0,4,4,1,4496
1,1,2,1,1,2,1,4497
1,0,1,1,0,1,1,4498
2,0,2,2,0,2,1,4499
12,6,18,12,6,18,1,4500
0,0,0,0,0,0,1,4501
0,0,0,0,0,0,1,4502
6,7,13,6,7,13,1,4503
0,0,0,0,0,0,1,4504
0,0,0,0,0,0,1,4505
2,0,2,2,0,2,1,4506
17,4,21,17,4,21,1,4507
1,0,1,1,0,1,1,4508
1,1,2,1,1,2,1,4509
0,2,2,0,2,2,1,4510
0,0,0,0,0,0,1,4511
16,5,21,16,5,21,1,4512
4,6,10,4,6,10,1,4513
2,0,2,2,0,2,1,4514
1,0,1,1,0,1,1,4515
2,0,2,2,0,2,1,4516
1,0,1,1,0,1,1,4517
6,5,11,6,5,11,1,4518
3,2,5,3,2,5,1,4519
0,2,2,0,2,2,1,4520
0,0,0,0,0,0,1,4521
1,0,1,1,0,1,1,4522
0,1,1,0,1,1,1,4523
0,2,2,0,2,2,1,4524
1,0,1,1,0,1,1,4525
5,3,8,5,3,8,1,4526
0,0,0,0,0,0,1,4527
0,0,0,0,0,0,1,4528
0,0,0,0,0,0,1,4529
2,5,7,2,5,7,1,4530
0,0,0,0,0,0,1,4531
0,0,0,0,0,0,1,4532
1,1,2,1,1,2,1,4533
0,0,0,0,0,0,1,4534
1,1,2,1,1,2,1,4535
0,2,2,0,2,2,1,4536
2,0,2,2,0,2,1,4537
1,0,1,1,0,1,1,4538
1,2,3,1,2,3,1,4539
0,3,3,0,3,3,1,4540
0,0,0,0,0,0,1,4541
5,0,5,5,0,5,1,4542
3,0,3,3,0,3,1,4543
0,0,0,0,0,0,1,4544
0,0,0,0,0,0,1,4545
210,112,322,210,112,322,1,4546
1,0,1,1,0,1,1,4547
24,49,73,24,49,73,1,4548
0,8,8,0,8,8,1,4549
5,25,30,5,25,30,1,4550
0,0,0,0,0,0,1,4551
0,0,0,0,0,0,1,4552
0,1,1,0,1,1,1,4553
18,29,47,18,29,47,1,4554
22,23,45,22,23,45,1,4555
2,0,2,2,0,2,1,4556
0,0,0,0,0,0,1,4557
0,0,0,0,0,0,1,4558
0,3,3,0,3,3,1,4559
0,0,0,0,0,0,1,4560
0,2,2,0,2,2,1,4561
0,0,0,0,0,0,1,4562
1,0,1,1,0,1,1,4563
0,2,2,0,2,2,1,4564
0,0,0,0,0,0,1,4565
0,4,4,0,4,4,1,4566
0,0,0,0,0,0,1,4567
0,0,0,0,0,0,1,4568
0,4,4,0,4,4,1,4569
0,0,0,0,0,0,1,4570
2,2,4,2,2,4,1,4571
2,0,2,2,0,2,1,4572
0,0,0,0,0,0,1,4573
0,0,0,0,0,0,1,4574
0,0,0,0,0,0,1,4575
5,0,5,5,0,5,1,4576
0,0,0,0,0,0,1,4577
1,1,2,1,1,2,1,4578
1,3,4,1,3,4,1,4579
0,0,0,0,0,0,1,4580
0,0,0,0,0,0,1,4581
1,0,1,1,0,1,1,4582
0,0,0,0,0,0,1,4583
0,0,0,0,0,0,1,4584
0,0,0,0,0,0,1,4585
0,0,0,0,0,0,1,4586
0,0,0,0,0,0,1,4587
1,0,1,1,0,1,1,4588
0,2,2,0,2,2,1,4589
5,0,5,5,0,5,1,4590
0,0,0,0,0,0,1,4591
1,3,4,1,3,4,1,4592
0,1,1,0,1,1,1,4593
1,2,3,1,2,3,1,4594
5,7,12,5,7,12,1,4595
323,182,505,323,182,505,1,4596
1589,1280,2869,1589,1280,2869,1,4597
63,31,94,63,31,94,1,4598
15,31,46,15,31,46,1,4599
4,6,10,4,6,10,1,4600
2,1,3,2,1,3,1,4601
1,0,1,1,0,1,1,4602
6,4,10,6,4,10,1,4603
4,8,12,4,8,12,1,4604
2,0,2,2,0,2,1,4605
1,0,1,1,0,1,1,4606
2,0,2,2,0,2,1,4607
3,3,6,3,3,6,1,4608
7,2,9,7,2,9,1,4609
1,1,2,1,1,2,1,4610
2,0,2,2,0,2,1,4611
0,1,1,0,1,1,1,4612
0,2,2,0,2,2,1,4613
18,5,23,18,5,23,1,4614
5,2,7,5,2,7,1,4615
0,1,1,0,1,1,1,4616
0,0,0,0,0,0,1,4617
0,0,0,0,0,0,1,4618
0,0,0,0,0,0,1,4619
1,9,10,1,9,10,1,4620
1,7,8,1,7,8,1,4621
2,7,9,2,7,9,1,4622
11,43,54,11,43,54,1,4623
1,0,1,1,0,1,1,4624
3,1,4,3,1,4,1,4625
0,6,6,0,6,6,1,4626
1,2,3,1,2,3,1,4627
26,33,59,26,33,59,1,4628
4,0,4,4,0,4,1,4629
4,4,8,4,4,8,1,4630
2,0,2,2,0,2,1,4631
2,0,2,2,0,2,1,4632
1,0,1,1,0,1,1,4633
17,21,38,17,21,38,1,4634
23,57,80,23,57,80,1,4635
1,0,1,1,0,1,1,4636
1,6,7,1,6,7,1,4637
0,2,2,0,2,2,1,4638
1,13,14,1,13,14,1,4639
8,11,19,8,11,19,1,4640
7,6,13,7,6,13,1,4641
0,0,0,0,0,0,1,4642
0,4,4,0,4,4,1,4643
0,0,0,0,0,0,1,4644
0,1,1,0,1,1,1,4645
0,0,0,0,0,0,1,4646
0,0,0,0,0,0,1,4647
4,3,7,4,3,7,1,4648
2,7,9,2,7,9,1,4649
1,0,1,1,0,1,1,4650
1,2,3,1,2,3,1,4651
4,24,28,4,24,28,1,4652
0,1,1,0,1,1,1,4653
1,0,1,1,0,1,1,4654
0,1,1,0,1,1,1,4655
0,0,0,0,0,0,1,4656
77,222,299,77,222,299,1,4657
0,1,1,0,1,1,1,4658
1,2,3,1,2,3,1,4659
1,2,3,1,2,3,1,4660
1,0,1,1,0,1,1,4661
0,2,2,0,2,2,1,4662
3,5,8,3,5,8,1,4663
14,118,132,14,118,132,1,4664
3,1,4,3,1,4,1,4665
104,38,142,104,38,142,1,4666
88,66,154,88,66,154,1,4667
1,4,5,1,4,5,1,4668
0,0,0,0,0,0,1,4669
5,13,18,5,13,18,1,4670
17,3,20,17,3,20,1,4671
0,0,0,0,0,0,1,4672
0,0,0,0,0,0,1,4673
4,0,4,4,0,4,1,4674
0,0,0,0,0,0,1,4675
1,1,2,1,1,2,1,4676
0,0,0,0,0,0,1,4677
0,0,0,0,0,0,1,4678
0,0,0,0,0,0,1,4679
1,2,3,1,2,3,1,4680
0,0,0,0,0,0,1,4681
2,0,2,2,0,2,1,4682
0,0,0,0,0,0,1,4683
0,0,0,0,0,0,1,4684
127,167,294,127,167,294,1,4685
189,176,365,189,176,365,1,4686
24,9,33,24,9,33,1,4687
1,5,6,1,5,6,1,4688
0,0,0,0,0,0,1,4689
4,1,5,4,1,5,1,4690
1,5,6,1,5,6,1,4691
0,0,0,0,0,0,1,4692
10,26,36,10,26,36,1,4693
0,0,0,0,0,0,1,4694
0,0,0,0,0,0,1,4695
0,0,0,0,0,0,1,4696
3,5,8,3,5,8,1,4697
2,0,2,2,0,2,1,4698
3,0,3,3,0,3,1,4699
5,3,8,5,3,8,1,4700
7,8,15,7,8,15,1,4701
7,1,8,7,1,8,1,4702
1,0,1,1,0,1,1,4703
0,0,0,0,0,0,1,4704
73,71,144,73,71,144,1,4705
2,6,8,2,6,8,1,4706
7,1,8,7,1,8,1,4707
0,0,0,0,0,0,1,4708
1,1,2,1,1,2,1,4709
1,12,13,1,12,13,1,4710
2,0,2,2,0,2,1,4711
1,0,1,1,0,1,1,4712
2,0,2,2,0,2,1,4713
0,0,0,0,0,0,1,4714
1,2,3,1,2,3,1,4715
5,16,21,5,16,21,1,4716
2,0,2,2,0,2,1,4717
3,0,3,3,0,3,1,4718
0,0,0,0,0,0,1,4719
0,0,0,0,0,0,1,4720
0,0,0,0,0,0,1,4721
2,1,3,2,1,3,1,4722
3,0,3,3,0,3,1,4723
0,0,0,0,0,0,1,4724
0,0,0,0,0,0,1,4725
0,0,0,0,0,0,1,4726
0,0,0,0,0,0,1,4727
1,1,2,1,1,2,1,4728
1,0,1,1,0,1,1,4729
0,0,0,0,0,0,1,4730
0,0,0,0,0,0,1,4731
0,0,0,0,0,0,1,4732
0,0,0,0,0,0,1,4733
0,0,0,0,0,0,1,4734
0,0,0,0,0,0,1,4735
1,0,1,1,0,1,1,4736
1,1,2,1,1,2,1,4737
0,0,0,0,0,0,1,4738
1,0,1,1,0,1,1,4739
0,0,0,0,0,0,1,4740
0,0,0,0,0,0,1,4741
0,0,0,0,0,0,1,4742
0,0,0,0,0,0,1,4743
0,0,0,0,0,0,1,4744
0,0,0,0,0,0,1,4745
6,1,7,6,1,7,1,4746
1,1,2,1,1,2,1,4747
0,3,3,0,3,3,1,4748
1,0,1,1,0,1,1,4749
0,0,0,0,0,0,1,4750
0,0,0,0,0,0,1,4751
0,0,0,0,0,0,1,4752
0,0,0,0,0,0,1,4753
0,0,0,0,0,0,1,4754
1,0,1,1,0,1,1,4755
6,0,6,6,0,6,1,4756
0,0,0,0,0,0,1,4757
0,0,0,0,0,0,1,4758
0,0,0,0,0,0,1,4759
0,0,0,0,0,0,1,4760
0,2,2,0,2,2,1,4761
0,0,0,0,0,0,1,4762
0,0,0,0,0,0,1,4763
0,0,0,0,0,0,1,4764
1,0,1,1,0,1,1,4765
0,0,0,0,0,0,1,4766
0,0,0,0,0,0,1,4767
0,1,1,0,1,1,1,4768
0,0,0,0,0,0,1,4769
0,0,0,0,0,0,1,4770
0,0,0,0,0,0,1,4771
2,1,3,2,1,3,1,4772
0,0,0,0,0,0,1,4773
0,0,0,0,0,0,1,4774
0,0,0,0,0,0,1,4775
0,0,0,0,0,0,1,4776
0,0,0,0,0,0,1,4777
2,0,2,2,0,2,1,4778
0,0,0,0,0,0,1,4779
0,1,1,0,1,1,1,4780
0,0,0,0,0,0,1,4781
0,0,0,0,0,0,1,4782
0,0,0,0,0,0,1,4783
0,0,0,0,0,0,1,4784
0,1,1,0,1,1,1,4785
0,0,0,0,0,0,1,4786
0,0,0,0,0,0,1,4787
0,0,0,0,0,0,1,4788
0,0,0,0,0,0,1,4789
1,0,1,1,0,1,1,4790
0,1,1,0,1,1,1,4791
0,1,1,0,1,1,1,4792
1,2,3,1,2,3,1,4793
0,0,0,0,0,0,1,4794
0,0,0,0,0,0,1,4795
0,0,0,0,0,0,1,4796
0,0,0,0,0,0,1,4797
0,3,3,0,3,3,1,4798
0,0,0,0,0,0,1,4799
4,0,4,4,0,4,1,4800
0,0,0,0,0,0,1,4801
0,5,5,0,5,5,1,4802
0,1,1,0,1,1,1,4803
0,0,0,0,0,0,1,4804
0,0,0,0,0,0,1,4805
0,0,0,0,0,0,1,4806
0,0,0,0,0,0,1,4807
7,2,9,7,2,9,1,4808
14,8,22,14,8,22,1,4809
0,0,0,0,0,0,1,4810
0,2,2,0,2,2,1,4811
0,0,0,0,0,0,1,4812
0,0,0,0,0,0,1,4813
0,0,0,0,0,0,1,4814
3,0,3,3,0,3,1,4815
0,0,0,0,0,0,1,4816
40,1,41,40,1,41,1,4817
1,0,1,1,0,1,1,4818
0,0,0,0,0,0,1,4819
1,0,1,1,0,1,1,4820
0,0,0,0,0,0,1,4821
0,0,0,0,0,0,1,4822
0,0,0,0,0,0,1,4823
0,0,0,0,0,0,1,4824
2,1,3,2,1,3,1,4825
6,7,13,6,7,13,1,4826
1,2,3,1,2,3,1,4827
0,0,0,0,0,0,1,4828
0,0,0,0,0,0,1,4829
105,58,163,105,58,163,1,4830
0,0,0,0,0,0,1,4831
41,86,127,41,86,127,1,4832
0,0,0,0,0,0,1,4833
0,0,0,0,0,0,1,4834
0,0,0,0,0,0,1,4835
0,0,0,0,0,0,1,4836
0,0,0,0,0,0,1,4837
3,7,10,3,7,10,1,4838
0,4,4,0,4,4,1,4839
0,0,0,0,0,0,1,4840
1,0,1,1,0,1,1,4841
0,0,0,0,0,0,1,4842
1,0,1,1,0,1,1,4843
0,1,1,0,1,1,1,4844
0,0,0,0,0,0,1,4845
0,0,0,0,0,0,1,4846
0,0,0,0,0,0,1,4847
0,0,0,0,0,0,1,4848
0,0,0,0,0,0,1,4849
0,0,0,0,0,0,1,4850
0,0,0,0,0,0,1,4851
0,3,3,0,3,3,1,4852
1,0,1,1,0,1,1,4853
0,0,0,0,0,0,1,4854
0,0,0,0,0,0,1,4855
0,0,0,0,0,0,1,4856
0,0,0,0,0,0,1,4857
0,0,0,0,0,0,1,4858
0,0,0,0,0,0,1,4859
0,0,0,0,0,0,1,4860
0,0,0,0,0,0,1,4861
0,0,0,0,0,0,1,4862
0,0,0,0,0,0,1,4863
0,0,0,0,0,0,1,4864
0,0,0,0,0,0,1,4865
0,0,0,0,0,0,1,4866
0,0,0,0,0,0,1,4867
0,0,0,0,0,0,1,4868
0,0,0,0,0,0,1,4869
0,0,0,0,0,0,1,4870
0,0,0,0,0,0,1,4871
0,0,0,0,0,0,1,4872
0,0,0,0,0,0,1,4873
0,0,0,0,0,0,1,4874
0,0,0,0,0,0,1,4875
0,0,0,0,0,0,1,4876
0,0,0,0,0,0,1,4877
0,0,0,0,0,0,1,4878
0,0,0,0,0,0,1,4879
0,0,0,0,0,0,1,4880
0,0,0,0,0,0,1,4881
0,0,0,0,0,0,1,4882
0,0,0,0,0,0,1,4883
0,0,0,0,0,0,1,4884
0,0,0,0,0,0,1,4885
0,0,0,0,0,0,1,4886
0,0,0,0,0,0,1,4887
0,0,0,0,0,0,1,4888
0,0,0,0,0,0,1,4889
0,0,0,0,0,0,1,4890
0,0,0,0,0,0,1,4891
0,0,0,0,0,0,1,4892
0,0,0,0,0,0,1,4893
0,0,0,0,0,0,1,4894
0,0,0,0,0,0,1,4895
0,0,0,0,0,0,1,4896
0,0,0,0,0,0,1,4897
0,0,0,0,0,0,1,4898
0,0,0,0,0,0,1,4899
0,0,0,0,0,0,1,4900
0,0,0,0,0,0,1,4901
0,0,0,0,0,0,1,4902
0,0,0,0,0,0,1,4903
0,0,0,0,0,0,1,4904
0,0,0,0,0,0,1,4905
0,0,0,0,0,0,1,4906
0,0,0,0,0,0,1,4907
0,0,0,0,0,0,1,4908
0,0,0,0,0,0,1,4909
0,0,0,0,0,0,1,4910
0,0,0,0,0,0,1,4911
0,0,0,0,0,0,1,4912
0,0,0,0,0,0,1,4913
0,0,0,0,0,0,1,4914
0,0,0,0,0,0,1,4915
0,0,0,0,0,0,1,4916
0,0,0,0,0,0,1,4917
0,0,0,0,0,0,1,4918
0,0,0,0,0,0,1,4919
0,0,0,0,0,0,1,4920
0,0,0,0,0,0,1,4921
0,0,0,0,0,0,1,4922
0,0,0,0,0,0,1,4923
0,0,0,0,0,0,1,4924
0,0,0,0,0,0,1,4925
0,0,0,0,0,0,1,4926
0,0,0,0,0,0,1,4927
0,0,0,0,0,0,1,4928
0,0,0,0,0,0,1,4929
0,0,0,0,0,0,1,4930
0,0,0,0,0,0,1,4931
0,0,0,0,0,0,1,4932
0,0,0,0,0,0,1,4933
0,0,0,0,0,0,1,4934
0,0,0,0,0,0,1,4935
0,0,0,0,0,0,1,4936
0,0,0,0,0,0,1,4937
0,0,0,0,0,0,1,4938
0,0,0,0,0,0,1,4939
0,0,0,0,0,0,1,4940
0,0,0,0,0,0,1,4941
0,0,0,0,0,0,1,4942
0,0,0,0,0,0,1,4943
0,0,0,0,0,0,1,4944
0,0,0,0,0,0,1,4945
0,0,0,0,0,0,1,4946
0,0,0,0,0,0,1,4947
2802,580,3382,114,23,137,2,1
9,1,10,0,0,0,2,2
8,3,11,0,0,0,2,3
86,32,118,1,2,3,2,4
98,48,146,4,1,5,2,5
20,20,40,0,0,0,2,6
24,13,37,0,0,0,2,7
122,37,159,2,3,5,2,8
18,3,21,0,0,0,2,9
15,3,18,0,0,0,2,10
685,367,1052,12,7,19,2,11
208,106,314,3,4,7,2,12
1326,1413,2739,47,59,106,2,13
2066,1183,3249,61,34,95,2,14
5533,5956,11489,332,305,637,2,15
2720,1478,4198,97,68,165,2,16
6080,4418,10498,90,124,214,2,17
2897,1575,4472,47,25,72,2,18
2062,1516,3578,165,354,519,2,19
49448,31828,81276,960,898,1858,2,20
24520,12631,37151,826,491,1317,2,21
26279,13380,39659,1483,965,2448,2,22
878,1202,2080,28,32,60,2,23
976,206,1182,6,3,9,2,24
27,16,43,0,2,2,2,25
18,9,27,0,0,0,2,26
444,912,1356,3,14,17,2,27
38,10,48,1,0,1,2,28
38,49,87,0,0,0,2,29
47,46,93,2,7,9,2,30
313,206,519,10,6,16,2,31
8,4,12,0,0,0,2,32
13,3,16,0,0,0,2,33
18,16,34,1,3,4,2,34
160,375,535,8,4,12,2,35
107,51,158,9,4,13,2,36
2954,1206,4160,67,42,109,2,37
23,6,29,0,0,0,2,38
499,317,816,13,15,28,2,39
345,119,464,8,6,14,2,40
39,11,50,1,1,2,2,41
1572,1816,3388,22,22,44,2,42
17,0,17,2,0,2,2,43
5,2,7,0,1,1,2,44
46,20,66,2,1,3,2,45
120,50,170,6,4,10,2,46
17,11,28,2,0,2,2,47
19033,9334,28367,424,325,749,2,48
1281,917,2198,78,48,126,2,49
8,11,19,1,2,3,2,50
16,21,37,1,2,3,2,51
63,42,105,0,0,0,2,52
203,83,286,6,5,11,2,53
243,200,443,4,2,6,2,54
80,142,222,5,4,9,2,55
115,143,258,1,0,1,2,56
239,419,658,2,7,9,2,57
491,241,732,8,4,12,2,58
692,252,944,2,3,5,2,59
279,235,514,4,4,8,2,60
619,523,1142,33,18,51,2,61
461,264,725,21,10,31,2,62
163,56,219,1,3,4,2,63
15,6,21,0,0,0,2,64
16,13,29,1,0,1,2,65
263,249,512,2,6,8,2,66
5147,3356,8503,78,83,161,2,67
6431,10123,16554,86,194,280,2,68
24,5,29,1,0,1,2,69
5,3,8,0,1,1,2,70
41,5,46,1,0,1,2,71
1,6,7,0,0,0,2,72
593,1000,1593,27,51,78,2,73
22,3,25,0,0,0,2,74
136,160,296,7,2,9,2,75
72,311,383,1,13,14,2,76
323,202,525,12,4,16,2,77
109,241,350,0,0,0,2,78
41,54,95,5,1,6,2,79
6,2,8,0,0,0,2,80
51,10,61,0,0,0,2,81
3,1,4,1,0,1,2,82
9,2,11,0,0,0,2,83
5,4,9,0,1,1,2,84
1,3,4,0,0,0,2,85
0,0,0,0,0,0,2,86
4,2,6,0,0,0,2,87
6,6,12,1,0,1,2,88
60,46,106,3,3,6,2,89
61,25,86,2,0,2,2,90
83,44,127,4,3,7,2,91
30,15,45,0,1,1,2,92
8,2,10,0,0,0,2,93
62,54,116,6,5,11,2,94
16,9,25,2,0,2,2,95
23,30,53,0,0,0,2,96
5,3,8,1,0,1,2,97
7,1,8,0,0,0,2,98
0,3,3,0,0,0,2,99
127896,41092,168988,992,453,1445,2,100
230,30,260,6,1,7,2,101
27,9,36,1,0,1,2,102
4,3,7,0,0,0,2,103
15,3,18,1,0,1,2,104
52,9,61,0,0,0,2,105
511,321,832,12,7,19,2,106
106,82,188,3,2,5,2,107
179,53,232,5,1,6,2,108
163,91,254,23,8,31,2,109
237,393,630,10,11,21,2,110
2,5,7,0,1,1,2,111
71,15,86,3,0,3,2,112
79,92,171,1,4,5,2,113
41,44,85,5,4,9,2,114
56,15,71,3,0,3,2,115
15,16,31,2,2,4,2,116
5,1,6,1,0,1,2,117
39,20,59,0,3,3,2,118
3,2,5,0,1,1,2,119
1,2,3,0,0,0,2,120
3,4,7,0,1,1,2,121
7,14,21,4,9,13,2,122
1742,421,2163,101,19,120,2,123
820,1127,1947,32,34,66,2,124
16,19,35,1,0,1,2,125
476,1015,1491,16,8,24,2,126
76,72,148,8,16,24,2,127
573,824,1397,31,56,87,2,128
13,6,19,1,2,3,2,129
13,5,18,0,0,0,2,130
114,74,188,2,4,6,2,131
18,17,35,3,1,4,2,132
100,58,158,7,4,11,2,133
24491,25310,49801,211,323,534,2,134
88,68,156,3,5,8,2,135
343,154,497,10,4,14,2,136
12,9,21,0,0,0,2,137
6,9,15,1,1,2,2,138
335,106,441,10,7,17,2,139
59,73,132,0,2,2,2,140
31,5,36,0,0,0,2,141
11,42,53,1,3,4,2,142
131,28,159,6,5,11,2,143
37,7,44,4,1,5,2,144
112,73,185,1,1,2,2,145
183,150,333,7,5,12,2,146
26391,26290,52681,1610,1233,2843,2,147
24,22,46,1,0,1,2,148
32,60,92,5,0,5,2,149
16,14,30,2,0,2,2,150
55,14,69,2,1,3,2,151
327,213,540,66,57,123,2,152
27,6,33,0,0,0,2,153
69,37,106,8,2,10,2,154
6,3,9,0,0,0,2,155
57,2,59,2,1,3,2,156
39,75,114,3,2,5,2,157
1008,730,1738,3,2,5,2,158
27,5,32,0,1,1,2,159
57,12,69,1,2,3,2,160
366,541,907,7,20,27,2,161
55,13,68,6,0,6,2,162
3,6,9,0,0,0,2,163
7,2,9,1,1,2,2,164
6,9,15,0,0,0,2,165
2,5,7,0,0,0,2,166
15,6,21,0,0,0,2,167
7,7,14,0,1,1,2,168
143,232,375,2,3,5,2,169
17,28,45,0,5,5,2,170
43,153,196,1,8,9,2,171
13,6,19,0,0,0,2,172
25,4,29,0,0,0,2,173
22,8,30,1,0,1,2,174
114,171,285,0,6,6,2,175
44,19,63,3,1,4,2,176
99,47,146,1,0,1,2,177
10,37,47,0,3,3,2,178
32,35,67,1,0,1,2,179
528,1097,1625,23,37,60,2,180
117,172,289,7,3,10,2,181
164,179,343,3,4,7,2,182
13,6,19,0,0,0,2,183
1222,4688,5910,49,185,234,2,184
39,153,192,1,1,2,2,185
327,43,370,15,6,21,2,186
297,25,322,12,3,15,2,187
64,109,173,0,1,1,2,188
93,36,129,1,0,1,2,189
67,37,104,4,4,8,2,190
14,10,24,0,1,1,2,191
141,52,193,1,3,4,2,192
917,1687,2604,6,28,34,2,193
32,9,41,1,0,1,2,194
15,5,20,0,0,0,2,195
41,6,47,0,0,0,2,196
8,2,10,0,0,0,2,197
18,6,24,2,0,2,2,198
22,12,34,0,0,0,2,199
76,19,95,3,0,3,2,200
12846,13888,26734,383,223,606,2,201
17,6,23,1,0,1,2,202
42,13,55,0,0,0,2,203
9,0,9,0,0,0,2,204
402,376,778,4,7,11,2,205
38,68,106,0,3,3,2,206
34,13,47,2,1,3,2,207
3510,837,4347,151,69,220,2,208
14,4,18,0,1,1,2,209
3,0,3,0,0,0,2,210
45,17,62,2,0,2,2,211
52,57,109,0,2,2,2,212
22,5,27,1,0,1,2,213
40,12,52,2,0,2,2,214
8,16,24,0,1,1,2,215
13,7,20,1,0,1,2,216
13,7,20,0,0,0,2,217
10,5,15,0,0,0,2,218
17,0,17,0,0,0,2,219
11,8,19,1,0,1,2,220
63,246,309,3,5,8,2,221
83,41,124,1,1,2,2,222
431,129,560,8,3,11,2,223
194,83,277,7,5,12,2,224
9,5,14,0,2,2,2,225
9,1,10,0,0,0,2,226
10,9,19,0,0,0,2,227
207,36,243,5,2,7,2,228
568,23,591,20,0,20,2,229
160,28,188,6,1,7,2,230
175,15,190,0,0,0,2,231
9,0,9,0,0,0,2,232
109,82,191,6,3,9,2,233
15,6,21,2,1,3,2,234
41,16,57,2,0,2,2,235
167,926,1093,10,44,54,2,236
295,319,614,11,8,19,2,237
48,353,401,4,13,17,2,238
30,124,154,1,6,7,2,239
24,122,146,1,4,5,2,240
54,30,84,0,0,0,2,241
108,134,242,2,0,2,2,242
4,3,7,0,0,0,2,243
55,13,68,2,0,2,2,244
37,31,68,2,0,2,2,245
5,4,9,0,0,0,2,246
3,0,3,0,0,0,2,247
24,5,29,0,0,0,2,248
4,3,7,0,0,0,2,249
8,15,23,0,0,0,2,250
6,4,10,0,0,0,2,251
16,13,29,2,0,2,2,252
5,10,15,0,1,1,2,253
2,14,16,0,0,0,2,254
4,1,5,0,0,0,2,255
2,1,3,0,0,0,2,256
5,0,5,0,0,0,2,257
3,3,6,0,0,0,2,258
1,0,1,0,0,0,2,259
1,2,3,0,0,0,2,260
1,1,2,0,0,0,2,261
17,18,35,0,0,0,2,262
221,178,399,7,5,12,2,263
33,15,48,0,0,0,2,264
88,49,137,4,4,8,2,265
22,29,51,1,2,3,2,266
19,6,25,1,2,3,2,267
3,4,7,0,0,0,2,268
1,2,3,0,0,0,2,269
5,1,6,0,1,1,2,270
4,3,7,0,0,0,2,271
44,10,54,0,0,0,2,272
5,5,10,0,0,0,2,273
27,7,34,0,0,0,2,274
4,0,4,0,0,0,2,275
1,1,2,0,0,0,2,276
4,0,4,0,0,0,2,277
2,0,2,0,0,0,2,278
5,0,5,0,0,0,2,279
0,0,0,-238,-69,-307,2,280
20,11,31,1,1,2,2,281
54,52,106,2,0,2,2,282
187,240,427,23,35,58,2,283
51,140,191,3,6,9,2,284
30,18,48,0,2,2,2,285
21,11,32,0,0,0,2,286
6,10,16,1,0,1,2,287
35,38,73,0,4,4,2,288
6,10,16,0,1,1,2,289
1164,366,1530,40,10,50,2,290
14,7,21,0,1,1,2,291
13,3,16,0,0,0,2,292
161,47,208,13,0,13,2,293
8,8,16,0,1,1,2,294
59,22,81,5,2,7,2,295
14,9,23,1,0,1,2,296
25,25,50,0,0,0,2,297
11,14,25,0,0,0,2,298
5,5,10,0,0,0,2,299
8,16,24,0,0,0,2,300
8,9,17,0,0,0,2,301
15,14,29,0,1,1,2,302
2,14,16,0,1,1,2,303
3,10,13,0,0,0,2,304
15,12,27,0,0,0,2,305
20,13,33,0,0,0,2,306
12,18,30,1,1,2,2,307
34,47,81,3,4,7,2,308
4,5,9,0,0,0,2,309
1,7,8,0,0,0,2,310
23,17,40,0,2,2,2,311
69,32,101,4,2,6,2,312
16,11,27,2,1,3,2,313
9,4,13,0,0,0,2,314
27,41,68,1,2,3,2,315
0,0,0,-4,-14,-18,2,316
398,224,622,2,0,2,2,317
141,252,393,5,14,19,2,318
6,19,25,0,0,0,2,319
10,95,105,0,6,6,2,320
43,32,75,5,2,7,2,321
27,20,47,1,0,1,2,322
22,11,33,0,1,1,2,323
11,13,24,0,0,0,2,324
12,6,18,0,0,0,2,325
6,30,36,0,1,1,2,326
27,87,114,0,0,0,2,327
106,82,188,3,9,12,2,328
11,4,15,2,1,3,2,329
33,53,86,0,1,1,2,330
13,48,61,0,0,0,2,331
11,23,34,0,3,3,2,332
15,5,20,1,0,1,2,333
18,4,22,1,0,1,2,334
145,149,294,12,7,19,2,335
8,6,14,1,1,2,2,336
1,7,8,0,0,0,2,337
11,4,15,1,0,1,2,338
4,1,5,0,0,0,2,339
34,48,82,0,2,2,2,340
42,73,115,0,1,1,2,341
9,3,12,0,0,0,2,342
1,0,1,0,0,0,2,343
9,5,14,0,0,0,2,344
17,23,40,0,0,0,2,345
32,12,44,1,0,1,2,346
10,10,20,0,0,0,2,347
5,10,15,0,2,2,2,348
14,30,44,0,0,0,2,349
1,0,1,0,0,0,2,350
1,2,3,0,1,1,2,351
0,0,0,0,0,0,2,352
1,3,4,0,0,0,2,353
0,0,0,0,0,0,2,354
6,7,13,0,0,0,2,355
7,0,7,0,0,0,2,356
0,0,0,0,0,0,2,357
0,0,0,0,0,0,2,358
5,6,11,0,2,2,2,359
2,1,3,0,0,0,2,360
1,1,2,0,0,0,2,361
3,1,4,0,0,0,2,362
26,85,111,1,14,15,2,363
43,85,128,1,11,12,2,364
8,8,16,0,0,0,2,365
13,13,26,0,0,0,2,366
19,78,97,0,17,17,2,367
1,9,10,0,1,1,2,368
10,3,13,0,0,0,2,369
2,2,4,0,0,0,2,370
1,0,1,0,0,0,2,371
5,0,5,0,0,0,2,372
20,72,92,3,7,10,2,373
18,3,21,0,0,0,2,374
23,10,33,1,1,2,2,375
1,6,7,0,0,0,2,376
1,1,2,0,0,0,2,377
4,4,8,0,0,0,2,378
586,42,628,57,33,90,2,379
8,5,13,2,3,5,2,380
2,1,3,0,0,0,2,381
25,6,31,1,1,2,2,382
51,18,69,0,2,2,2,383
21,6,27,0,0,0,2,384
5,2,7,1,0,1,2,385
3,0,3,0,0,0,2,386
22,8,30,1,1,2,2,387
12,11,23,0,0,0,2,388
24,27,51,1,0,1,2,389
205,51,256,10,1,11,2,390
73,54,127,1,0,1,2,391
93,33,126,1,1,2,2,392
12,7,19,0,0,0,2,393
11,27,38,1,3,4,2,394
4,6,10,0,0,0,2,395
13,3,16,0,0,0,2,396
3,0,3,0,0,0,2,397
13,6,19,1,1,2,2,398
8,37,45,3,10,13,2,399
6,7,13,1,0,1,2,400
1,0,1,0,0,0,2,401
4,1,5,0,0,0,2,402
1,7,8,0,0,0,2,403
0,0,0,0,0,0,2,404
2,0,2,0,0,0,2,405
0,1,1,0,0,0,2,406
21,24,45,4,0,4,2,407
2,1,3,0,0,0,2,408
5,12,17,0,0,0,2,409
39,22,61,3,3,6,2,410
4,16,20,0,0,0,2,411
6,4,10,0,0,0,2,412
16,12,28,0,0,0,2,413
43,39,82,2,0,2,2,414
34,97,131,1,7,8,2,415
1,2,3,0,0,0,2,416
2,5,7,0,0,0,2,417
141,55,196,16,2,18,2,418
55,45,100,3,4,7,2,419
98,37,135,0,0,0,2,420
6,1,7,0,0,0,2,421
0,1,1,0,0,0,2,422
3,2,5,0,0,0,2,423
6,8,14,0,0,0,2,424
0,2,2,0,0,0,2,425
3,0,3,1,0,1,2,426
8,18,26,0,2,2,2,427
6,0,6,0,0,0,2,428
83,193,276,2,21,23,2,429
28,81,109,5,17,22,2,430
4,20,24,1,1,2,2,431
17,19,36,0,2,2,2,432
18,86,104,0,2,2,2,433
16,4,20,3,0,3,2,434
22,4,26,1,1,2,2,435
8,3,11,0,0,0,2,436
8,0,8,0,0,0,2,437
0,0,0,0,0,0,2,438
5,15,20,0,0,0,2,439
16,10,26,0,0,0,2,440
6,0,6,0,0,0,2,441
7,14,21,0,1,1,2,442
10,10,20,0,0,0,2,443
2,4,6,0,0,0,2,444
13,3,16,0,0,0,2,445
32,4,36,0,0,0,2,446
1424,602,2026,68,33,101,2,447
531,187,718,31,10,41,2,448
470,171,641,32,6,38,2,449
367,78,445,22,6,28,2,450
101,493,594,5,12,17,2,451
9,34,43,0,2,2,2,452
0,0,0,-597,-63,-660,2,453
65,31,96,3,0,3,2,454
3,7,10,0,0,0,2,455
13,0,13,0,0,0,2,456
492,82,574,3,1,4,2,457
12,5,17,0,0,0,2,458
4,2,6,0,0,0,2,459
1,1,2,0,0,0,2,460
7,5,12,0,0,0,2,461
8,1,9,0,0,0,2,462
20,6,26,0,0,0,2,463
4,1,5,0,0,0,2,464
33,4,37,5,0,5,2,465
56,52,108,3,0,3,2,466
947,4960,5907,74,273,347,2,467
10,68,78,1,5,6,2,468
43,55,98,0,0,0,2,469
100,11,111,2,1,3,2,470
6,6,12,0,0,0,2,471
11,2,13,0,0,0,2,472
6,1,7,0,0,0,2,473
17,10,27,0,1,1,2,474
21,9,30,1,1,2,2,475
4,0,4,2,0,2,2,476
0,2,2,0,0,0,2,477
13,2,15,0,0,0,2,478
32,22,54,0,0,0,2,479
12,5,17,1,0,1,2,480
502,307,809,37,14,51,2,481
12,4,16,0,0,0,2,482
7,3,10,1,0,1,2,483
26,6,32,1,0,1,2,484
21,1,22,1,0,1,2,485
1,2,3,0,0,0,2,486
46,16,62,4,0,4,2,487
176,209,385,10,14,24,2,488
4,2,6,2,0,2,2,489
3,3,6,0,0,0,2,490
2,0,2,0,0,0,2,491
7,10,17,0,1,1,2,492
3,5,8,0,0,0,2,493
179,418,597,12,16,28,2,494
185,487,672,2,11,13,2,495
3,2,5,0,0,0,2,496
4,4,8,0,0,0,2,497
16,32,48,1,2,3,2,498
67,102,169,4,11,15,2,499
33,29,62,0,2,2,2,500
4,0,4,0,0,0,2,501
12,8,20,0,0,0,2,502
11,7,18,1,1,2,2,503
0,2,2,0,0,0,2,504
5,1,6,0,0,0,2,505
3,0,3,0,0,0,2,506
9,3,12,0,1,1,2,507
5,2,7,0,0,0,2,508
12,9,21,1,0,1,2,509
15,4,19,1,0,1,2,510
16,3,19,0,0,0,2,511
432,930,1362,67,99,166,2,512
124,452,576,10,21,31,2,513
11,11,22,0,0,0,2,514
5,0,5,0,0,0,2,515
1352,161,1513,46,5,51,2,516
48,30,78,0,0,0,2,517
12,4,16,0,0,0,2,518
6,0,6,0,0,0,2,519
10,1,11,0,0,0,2,520
16,4,20,0,0,0,2,521
13,2,15,0,0,0,2,522
39,36,75,2,1,3,2,523
23,18,41,0,1,1,2,524
55,9,64,0,0,0,2,525
33,1,34,2,0,2,2,526
25,11,36,0,0,0,2,527
51361,47689,99050,1649,1069,2718,2,528
412,795,1207,20,13,33,2,529
1562,3139,4701,26,37,63,2,530
308,715,1023,8,10,18,2,531
23146,52249,75395,484,703,1187,2,532
5111,16100,21211,23,40,63,2,533
16012,42993,59005,289,939,1228,2,534
3772,6874,10646,146,190,336,2,535
5962,13778,19740,204,282,486,2,536
3879,11027,14906,166,466,632,2,537
110,173,283,9,5,14,2,538
98,88,186,3,2,5,2,539
990,972,1962,40,41,81,2,540
428,516,944,26,20,46,2,541
1424,879,2303,32,17,49,2,542
961,623,1584,46,17,63,2,543
885,500,1385,15,13,28,2,544
66,54,120,1,3,4,2,545
480,621,1101,29,31,60,2,546
234,285,519,2,2,4,2,547
2645,3010,5655,177,189,366,2,548
5,5,10,0,0,0,2,549
8,4,12,0,1,1,2,550
10,4,14,0,1,1,2,551
5,2,7,0,0,0,2,552
9,3,12,0,1,1,2,553
34,9,43,1,1,2,2,554
12,0,12,1,0,1,2,555
24,2,26,0,0,0,2,556
2,0,2,0,0,0,2,557
160,19,179,2,0,2,2,558
2,2,4,0,0,0,2,559
3,3,6,0,0,0,2,560
17,2,19,0,0,0,2,561
2,4,6,0,0,0,2,562
2,1,3,0,0,0,2,563
7,2,9,0,0,0,2,564
4,4,8,0,0,0,2,565
12,3,15,0,0,0,2,566
5,2,7,0,0,0,2,567
4,3,7,0,1,1,2,568
12,3,15,0,0,0,2,569
28,34,62,1,0,1,2,570
6,3,9,6,3,9,2,571
3,12,15,0,0,0,2,572
8,21,29,8,21,29,2,573
1,0,1,0,0,0,2,574
35,9,44,1,0,1,2,575
11,3,14,0,0,0,2,576
0,0,0,-23,-7,-30,2,577
5,10,15,0,0,0,2,578
58,115,173,7,12,19,2,579
4,20,24,0,3,3,2,580
5,21,26,1,6,7,2,581
58,22,80,3,2,5,2,582
6,4,10,0,0,0,2,583
6,4,10,0,0,0,2,584
27,10,37,0,0,0,2,585
3,13,16,0,0,0,2,586
9,3,12,0,2,2,2,587
30,25,55,1,2,3,2,588
19,17,36,0,1,1,2,589
19,54,73,1,4,5,2,590
14,23,37,0,1,1,2,591
6867,5323,12190,246,246,492,2,592
42,40,82,3,2,5,2,593
32,20,52,1,2,3,2,594
35,110,145,4,13,17,2,595
2,5,7,0,0,0,2,596
6,4,10,0,0,0,2,597
3,1,4,0,0,0,2,598
0,2,2,0,0,0,2,599
124,56,180,1,3,4,2,600
16,4,20,0,0,0,2,601
41,31,72,5,0,5,2,602
26,8,34,3,1,4,2,603
112,17,129,2,2,4,2,604
80,21,101,1,1,2,2,605
9,2,11,2,0,2,2,606
50,19,69,9,5,14,2,607
23,14,37,0,1,1,2,608
16,1,17,1,0,1,2,609
91,6,97,3,0,3,2,610
31,7,38,1,0,1,2,611
1,2,3,1,0,1,2,612
379,151,530,49,19,68,2,613
3,2,5,0,0,0,2,614
4,0,4,0,0,0,2,615
2,0,2,0,0,0,2,616
4,9,13,0,0,0,2,617
4,0,4,0,0,0,2,618
2,0,2,1,0,1,2,619
5,1,6,0,0,0,2,620
3,3,6,0,0,0,2,621
11,5,16,0,0,0,2,622
5,5,10,0,0,0,2,623
1,0,1,0,0,0,2,624
10,35,45,0,6,6,2,625
1,0,1,0,0,0,2,626
2,0,2,0,0,0,2,627
3,1,4,0,0,0,2,628
1,3,4,0,0,0,2,629
7,3,10,0,0,0,2,630
5,8,13,0,2,2,2,631
28,19,47,0,0,0,2,632
0,2,2,0,0,0,2,633
2,0,2,0,0,0,2,634
327,42,369,4,1,5,2,635
1,2,3,0,0,0,2,636
3,4,7,0,0,0,2,637
7,6,13,0,0,0,2,638
6,0,6,1,0,1,2,639
9,5,14,0,0,0,2,640
5,7,12,0,0,0,2,641
4,0,4,0,0,0,2,642
2,1,3,0,0,0,2,643
2,0,2,0,0,0,2,644
5,1,6,0,0,0,2,645
1,2,3,0,0,0,2,646
3,0,3,0,0,0,2,647
0,0,0,0,0,0,2,648
5,3,8,0,0,0,2,649
30,25,55,0,2,2,2,650
867,378,1245,22,8,30,2,651
6922,817,7739,220,32,252,2,652
512,556,1068,31,26,57,2,653
516,523,1039,12,14,26,2,654
20,4,24,0,0,0,2,655
0,0,0,-85,-44,-129,2,656
5,4,9,0,0,0,2,657
5,3,8,0,0,0,2,658
61,120,181,6,26,32,2,659
1185,4593,5778,60,231,291,2,660
8,0,8,0,0,0,2,661
7,4,11,0,1,1,2,662
8,7,15,0,0,0,2,663
1,2,3,0,0,0,2,664
6,3,9,0,0,0,2,665
43,31,74,0,3,3,2,666
35,48,83,0,3,3,2,667
5,3,8,0,0,0,2,668
11,13,24,0,0,0,2,669
11,2,13,1,0,1,2,670
17,19,36,2,0,2,2,671
2,2,4,0,0,0,2,672
2,9,11,0,0,0,2,673
3,9,12,0,0,0,2,674
11,6,17,0,0,0,2,675
2,2,4,0,0,0,2,676
3,15,18,0,0,0,2,677
3,5,8,0,0,0,2,678
2,3,5,0,0,0,2,679
3,4,7,0,2,2,2,680
39,89,128,0,5,5,2,681
3,8,11,0,0,0,2,682
1,2,3,0,0,0,2,683
58,55,113,2,3,5,2,684
34,43,77,1,3,4,2,685
311,154,465,20,9,29,2,686
21,58,79,1,7,8,2,687
40,113,153,1,4,5,2,688
5,8,13,0,0,0,2,689
7,13,20,0,1,1,2,690
19,24,43,0,1,1,2,691
13,47,60,0,3,3,2,692
37,134,171,1,8,9,2,693
14,14,28,1,0,1,2,694
33,12,45,1,2,3,2,695
19,24,43,2,0,2,2,696
1,3,4,0,0,0,2,697
75,292,367,3,16,19,2,698
37,42,79,2,0,2,2,699
11,11,22,1,1,2,2,700
8,2,10,0,0,0,2,701
6,5,11,2,0,2,2,702
3,3,6,1,0,1,2,703
9,7,16,0,0,0,2,704
1,7,8,0,0,0,2,705
7,10,17,0,0,0,2,706
11,14,25,1,0,1,2,707
10,2,12,0,0,0,2,708
1,15,16,0,0,0,2,709
4,15,19,0,0,0,2,710
8,1,9,0,0,0,2,711
4,0,4,0,0,0,2,712
60,270,330,2,7,9,2,713
28,30,58,0,0,0,2,714
57,83,140,0,5,5,2,715
59,110,169,5,1,6,2,716
37,68,105,0,3,3,2,717
14,5,19,1,0,1,2,718
18,22,40,0,0,0,2,719
47,31,78,0,0,0,2,720
2,7,9,0,0,0,2,721
29,218,247,1,13,14,2,722
16,85,101,0,1,1,2,723
11,15,26,0,0,0,2,724
4,8,12,0,0,0,2,725
5,3,8,0,0,0,2,726
4,3,7,0,0,0,2,727
0,3,3,0,0,0,2,728
2,5,7,0,0,0,2,729
3,5,8,0,0,0,2,730
1,4,5,0,0,0,2,731
2,3,5,0,0,0,2,732
2,5,7,0,0,0,2,733
1,4,5,0,0,0,2,734
5,7,12,0,0,0,2,735
4,2,6,0,0,0,2,736
0,0,0,0,0,0,2,737
2,2,4,0,0,0,2,738
7,1,8,0,0,0,2,739
2,0,2,0,0,0,2,740
9,34,43,1,1,2,2,741
0,3,3,0,0,0,2,742
11,1,12,0,0,0,2,743
24,10,34,1,0,1,2,744
34,71,105,4,16,20,2,745
2,11,13,0,0,0,2,746
4,1,5,0,0,0,2,747
6,7,13,1,0,1,2,748
4,1,5,0,0,0,2,749
2,2,4,0,0,0,2,750
6,1,7,0,0,0,2,751
6,12,18,2,1,3,2,752
49,80,129,0,4,4,2,753
5,7,12,0,0,0,2,754
2,3,5,0,0,0,2,755
3,3,6,1,1,2,2,756
8,5,13,1,0,1,2,757
1,0,1,0,0,0,2,758
1,0,1,0,0,0,2,759
0,0,0,0,0,0,2,760
1,0,1,0,0,0,2,761
0,0,0,0,0,0,2,762
1,1,2,0,0,0,2,763
1,0,1,0,0,0,2,764
1,1,2,1,0,1,2,765
0,0,0,0,0,0,2,766
4,9,13,0,0,0,2,767
7,18,25,0,0,0,2,768
0,4,4,0,0,0,2,769
11,0,11,1,0,1,2,770
1,1,2,0,0,0,2,771
0,1,1,0,0,0,2,772
23,5,28,0,0,0,2,773
1548,392,1940,32,4,36,2,774
49,32,81,1,0,1,2,775
64,11,75,2,0,2,2,776
710,879,1589,49,113,162,2,777
94,896,990,12,138,150,2,778
7,6,13,0,0,0,2,779
9,6,15,0,0,0,2,780
15,36,51,0,0,0,2,781
4,1,5,0,0,0,2,782
6,11,17,1,0,1,2,783
564,996,1560,12,24,36,2,784
183,56,239,8,0,8,2,785
382,605,987,12,11,23,2,786
21,46,67,1,2,3,2,787
247,882,1129,5,2,7,2,788
115,206,321,2,0,2,2,789
61,72,133,1,1,2,2,790
136,733,869,5,29,34,2,791
8,1,9,0,0,0,2,792
6,3,9,0,0,0,2,793
7,3,10,0,0,0,2,794
197,43,240,18,3,21,2,795
9,7,16,0,0,0,2,796
5,1,6,0,0,0,2,797
6,0,6,0,0,0,2,798
35,6,41,2,0,2,2,799
3,1,4,0,0,0,2,800
86,15,101,1,0,1,2,801
147,22,169,2,0,2,2,802
134,125,259,4,2,6,2,803
20,8,28,2,0,2,2,804
13,21,34,0,1,1,2,805
17,6,23,1,2,3,2,806
65,87,152,5,13,18,2,807
7,8,15,0,0,0,2,808
7,0,7,0,0,0,2,809
7,4,11,0,0,0,2,810
2,2,4,0,0,0,2,811
2,1,3,1,0,1,2,812
34,16,50,0,0,0,2,813
5,0,5,0,0,0,2,814
50,19,69,1,3,4,2,815
84,4,88,0,0,0,2,816
89,109,198,1,1,2,2,817
347,171,518,17,10,27,2,818
156,98,254,11,2,13,2,819
1891,1236,3127,115,59,174,2,820
34,23,57,1,2,3,2,821
1722,647,2369,103,29,132,2,822
30,52,82,0,1,1,2,823
613,242,855,44,10,54,2,824
1068,386,1454,45,6,51,2,825
763,593,1356,13,8,21,2,826
13,4,17,0,0,0,2,827
30,14,44,0,0,0,2,828
7,3,10,0,0,0,2,829
15,21,36,0,1,1,2,830
4,1,5,0,0,0,2,831
37,10,47,1,1,2,2,832
4,4,8,0,0,0,2,833
31,7,38,3,1,4,2,834
4,2,6,0,0,0,2,835
91,117,208,7,7,14,2,836
8,3,11,1,0,1,2,837
21,17,38,1,1,2,2,838
8,3,11,0,0,0,2,839
4,4,8,0,0,0,2,840
36,20,56,0,2,2,2,841
50,57,107,0,8,8,2,842
20,43,63,1,0,1,2,843
2,9,11,0,0,0,2,844
8,5,13,0,0,0,2,845
23,5,28,1,0,1,2,846
3,1,4,1,0,1,2,847
6,1,7,1,0,1,2,848
14,9,23,0,0,0,2,849
273,261,534,24,18,42,2,850
439,389,828,40,32,72,2,851
4,5,9,0,0,0,2,852
37,26,63,3,4,7,2,853
7,20,27,1,2,3,2,854
6,15,21,0,0,0,2,855
13,21,34,0,0,0,2,856
33,9,42,1,1,2,2,857
14,5,19,1,0,1,2,858
9,20,29,0,0,0,2,859
9,5,14,0,2,2,2,860
16,5,21,0,0,0,2,861
48,40,88,0,1,1,2,862
7,45,52,2,3,5,2,863
14,7,21,0,0,0,2,864
23,108,131,5,6,11,2,865
29,11,40,2,0,2,2,866
4,8,12,0,0,0,2,867
8,0,8,0,0,0,2,868
11,3,14,0,0,0,2,869
61,5,66,2,0,2,2,870
1263,208,1471,128,22,150,2,871
126,68,194,4,3,7,2,872
50,18,68,1,1,2,2,873
34,21,55,4,1,5,2,874
6,4,10,0,0,0,2,875
163,83,246,4,3,7,2,876
157,68,225,4,2,6,2,877
131,76,207,8,3,11,2,878
13,6,19,2,0,2,2,879
8,9,17,0,0,0,2,880
76,7,83,0,0,0,2,881
10,34,44,2,1,3,2,882
7,8,15,0,1,1,2,883
10,6,16,0,3,3,2,884
4,10,14,1,2,3,2,885
10,5,15,0,0,0,2,886
11,5,16,0,0,0,2,887
14,4,18,0,0,0,2,888
17,20,37,1,0,1,2,889
7,3,10,0,0,0,2,890
22,14,36,1,0,1,2,891
1,0,1,0,0,0,2,892
14,12,26,0,0,0,2,893
8,3,11,1,0,1,2,894
98,36,134,5,2,7,2,895
28,28,56,0,0,0,2,896
5,0,5,0,0,0,2,897
2,0,2,0,0,0,2,898
0,1,1,0,0,0,2,899
1,3,4,0,0,0,2,900
3,3,6,0,0,0,2,901
2,2,4,0,0,0,2,902
12,10,22,0,0,0,2,903
10,13,23,1,0,1,2,904
10,15,25,0,0,0,2,905
24,8,32,1,0,1,2,906
2,4,6,0,0,0,2,907
7,4,11,0,1,1,2,908
4,0,4,0,0,0,2,909
3,3,6,0,0,0,2,910
4,1,5,0,0,0,2,911
3,5,8,0,1,1,2,912
37,8,45,0,0,0,2,913
12,13,25,0,0,0,2,914
4,17,21,0,0,0,2,915
3,4,7,0,0,0,2,916
0,4,4,0,0,0,2,917
2,5,7,0,0,0,2,918
29,123,152,0,3,3,2,919
21,14,35,1,0,1,2,920
18,4,22,1,0,1,2,921
0,1,1,0,1,1,2,922
5,7,12,0,3,3,2,923
2,1,3,0,0,0,2,924
6,14,20,2,5,7,2,925
1,0,1,0,0,0,2,926
0,3,3,0,0,0,2,927
1,3,4,0,0,0,2,928
5,13,18,0,4,4,2,929
4,1,5,0,0,0,2,930
0,1,1,0,0,0,2,931
2,3,5,0,1,1,2,932
0,2,2,0,0,0,2,933
1,2,3,0,0,0,2,934
0,3,3,0,0,0,2,935
0,0,0,0,0,0,2,936
1,2,3,0,0,0,2,937
4,11,15,0,1,1,2,938
0,1,1,0,0,0,2,939
2,4,6,0,0,0,2,940
9,6,15,0,1,1,2,941
2,2,4,0,0,0,2,942
16,27,43,1,2,3,2,943
2,1,3,0,0,0,2,944
24,48,72,0,0,0,2,945
3,4,7,0,0,0,2,946
1,3,4,0,0,0,2,947
41,46,87,0,0,0,2,948
1,1,2,0,0,0,2,949
3,0,3,0,0,0,2,950
2341,912,3253,21,11,32,2,951
345,127,472,14,4,18,2,952
2,0,2,0,0,0,2,953
8,2,10,0,0,0,2,954
12,5,17,1,0,1,2,955
48,21,69,1,1,2,2,956
38,99,137,0,0,0,2,957
1,1,2,0,0,0,2,958
285,548,833,9,8,17,2,959
5,1,6,0,0,0,2,960
2,4,6,0,0,0,2,961
4,1,5,0,0,0,2,962
14,5,19,0,0,0,2,963
14,3,17,1,0,1,2,964
2,0,2,0,0,0,2,965
5,4,9,0,0,0,2,966
7,4,11,1,0,1,2,967
5,4,9,0,0,0,2,968
2,2,4,1,0,1,2,969
3,0,3,0,0,0,2,970
6,1,7,0,0,0,2,971
2,1,3,0,0,0,2,972
26,13,39,1,1,2,2,973
2,7,9,0,1,1,2,974
17,5,22,1,0,1,2,975
10,3,13,0,0,0,2,976
10,6,16,1,0,1,2,977
17,23,40,2,3,5,2,978
58,16,74,3,0,3,2,979
24,5,29,4,0,4,2,980
3,6,9,0,1,1,2,981
6,1,7,0,0,0,2,982
7,11,18,0,1,1,2,983
293,42,335,5,2,7,2,984
13,2,15,1,0,1,2,985
36,12,48,3,1,4,2,986
22,7,29,0,0,0,2,987
27,12,39,2,1,3,2,988
8,4,12,1,0,1,2,989
2,1,3,0,0,0,2,990
16,7,23,0,0,0,2,991
9,0,9,0,0,0,2,992
5,1,6,0,0,0,2,993
7,3,10,0,0,0,2,994
6,2,8,1,0,1,2,995
1319,1544,2863,33,58,91,2,996
0,0,0,-9,-14,-23,2,997
46,76,122,2,3,5,2,998
23,41,64,1,3,4,2,999
12,14,26,1,0,1,2,1000
1,5,6,0,1,1,2,1001
7,5,12,1,0,1,2,1002
17,3,20,2,0,2,2,1003
4,5,9,0,1,1,2,1004
0,0,0,0,0,0,2,1005
821,489,1310,39,29,68,2,1006
70,195,265,2,1,3,2,1007
5,1,6,0,0,0,2,1008
6,5,11,0,0,0,2,1009
5,2,7,0,0,0,2,1010
6,1,7,0,0,0,2,1011
18,6,24,0,0,0,2,1012
5,10,15,0,0,0,2,1013
1,8,9,0,1,1,2,1014
3,2,5,0,1,1,2,1015
36,46,82,3,9,12,2,1016
0,0,0,0,0,0,2,1017
5,0,5,3,0,3,2,1018
1,3,4,0,0,0,2,1019
2,0,2,0,0,0,2,1020
1,0,1,0,0,0,2,1021
0,0,0,0,0,0,2,1022
1,1,2,0,0,0,2,1023
1,0,1,0,0,0,2,1024
0,2,2,0,0,0,2,1025
0,1,1,0,0,0,2,1026
167,213,380,22,15,37,2,1027
4,9,13,0,0,0,2,1028
0,1,1,0,0,0,2,1029
3,0,3,0,0,0,2,1030
5,1,6,0,0,0,2,1031
6,0,6,1,0,1,2,1032
4,6,10,1,0,1,2,1033
1,1,2,0,0,0,2,1034
2,2,4,0,0,0,2,1035
0,2,2,0,1,1,2,1036
2,0,2,0,0,0,2,1037
12,1,13,0,0,0,2,1038
3,7,10,0,0,0,2,1039
33,87,120,0,2,2,2,1040
157,572,729,10,45,55,2,1041
6,1,7,0,0,0,2,1042
8,10,18,0,0,0,2,1043
3,5,8,0,0,0,2,1044
14,6,20,0,0,0,2,1045
7,3,10,0,0,0,2,1046
128,149,277,7,8,15,2,1047
59,281,340,3,8,11,2,1048
55,27,82,0,0,0,2,1049
2,1,3,0,0,0,2,1050
23,17,40,1,0,1,2,1051
169,292,461,5,18,23,2,1052
11,11,22,0,0,0,2,1053
10,14,24,1,0,1,2,1054
15,2,17,0,0,0,2,1055
1,0,1,0,0,0,2,1056
13,7,20,0,0,0,2,1057
227,266,493,6,3,9,2,1058
362,239,601,16,9,25,2,1059
6,2,8,0,0,0,2,1060
64,182,246,6,18,24,2,1061
5,13,18,0,0,0,2,1062
3,16,19,0,0,0,2,1063
1174,1730,2904,83,76,159,2,1064
138,759,897,5,54,59,2,1065
197,642,839,7,4,11,2,1066
78,252,330,11,14,25,2,1067
31,63,94,1,3,4,2,1068
11,10,21,0,0,0,2,1069
0,0,0,-38,-120,-158,2,1070
20,16,36,0,0,0,2,1071
184,248,432,3,14,17,2,1072
2,4,6,0,0,0,2,1073
0,2,2,0,0,0,2,1074
1,2,3,0,0,0,2,1075
7,0,7,0,0,0,2,1076
3,3,6,0,0,0,2,1077
2,23,25,0,0,0,2,1078
8,7,15,0,0,0,2,1079
15,15,30,0,0,0,2,1080
2,4,6,0,0,0,2,1081
23,9,32,0,0,0,2,1082
7,10,17,1,0,1,2,1083
1709,1227,2936,76,57,133,2,1084
18,4,22,1,0,1,2,1085
7,4,11,0,0,0,2,1086
40,27,67,6,5,11,2,1087
7,4,11,0,0,0,2,1088
22,22,44,0,0,0,2,1089
33,76,109,2,2,4,2,1090
0,1,1,0,0,0,2,1091
56,30,86,2,0,2,2,1092
243,101,344,5,5,10,2,1093
81,12,93,1,0,1,2,1094
23,10,33,1,0,1,2,1095
29,12,41,1,2,3,2,1096
37,18,55,1,1,2,2,1097
67,41,108,1,0,1,2,1098
1694,1207,2901,23,19,42,2,1099
13,17,30,0,0,0,2,1100
49,20,69,0,0,0,2,1101
26,3,29,2,0,2,2,1102
61,32,93,5,0,5,2,1103
5,14,19,0,0,0,2,1104
14,6,20,1,0,1,2,1105
13,3,16,0,0,0,2,1106
3,2,5,0,0,0,2,1107
2,1,3,1,0,1,2,1108
4,6,10,0,0,0,2,1109
5,2,7,0,0,0,2,1110
3,0,3,0,0,0,2,1111
22,1,23,1,0,1,2,1112
19,1,20,1,0,1,2,1113
8,5,13,0,0,0,2,1114
8,6,14,1,0,1,2,1115
5,19,24,0,0,0,2,1116
15,8,23,0,0,0,2,1117
15,11,26,0,2,2,2,1118
373,1161,1534,28,103,131,2,1119
163,963,1126,15,65,80,2,1120
73,206,279,4,3,7,2,1121
1360,253,1613,14,3,17,2,1122
18,4,22,1,0,1,2,1123
466,1265,1731,31,57,88,2,1124
43,79,122,2,0,2,2,1125
4,3,7,0,0,0,2,1126
1,8,9,0,0,0,2,1127
7,25,32,0,2,2,2,1128
0,2,2,0,0,0,2,1129
2,1,3,0,0,0,2,1130
1,2,3,0,0,0,2,1131
2,0,2,0,0,0,2,1132
641,928,1569,4,3,7,2,1133
2,0,2,0,0,0,2,1134
4,5,9,0,0,0,2,1135
28,45,73,1,3,4,2,1136
169,268,437,5,9,14,2,1137
10,3,13,0,0,0,2,1138
15,0,15,0,0,0,2,1139
8,10,18,1,1,2,2,1140
0,2,2,0,0,0,2,1141
8,11,19,0,0,0,2,1142
10,31,41,2,1,3,2,1143
22,4,26,1,0,1,2,1144
4,6,10,1,1,2,2,1145
4027,3201,7228,491,699,1190,2,1146
152,8,160,0,0,0,2,1147
13,6,19,1,0,1,2,1148
43,28,71,2,1,3,2,1149
40,17,57,0,0,0,2,1150
54,192,246,1,5,6,2,1151
229,591,820,6,15,21,2,1152
56,178,234,1,2,3,2,1153
28,10,38,0,0,0,2,1154
12,13,25,0,0,0,2,1155
50,65,115,2,10,12,2,1156
15,10,25,0,0,0,2,1157
11,2,13,0,0,0,2,1158
26,8,34,0,1,1,2,1159
43,37,80,0,0,0,2,1160
42,85,127,0,1,1,2,1161
195,307,502,2,4,6,2,1162
41,91,132,3,3,6,2,1163
39,42,81,0,0,0,2,1164
8,1,9,0,0,0,2,1165
2180,3517,5697,52,82,134,2,1166
292,227,519,4,4,8,2,1167
9,22,31,0,2,2,2,1168
183,153,336,5,4,9,2,1169
12075,5647,17722,217,189,406,2,1170
30,24,54,0,0,0,2,1171
194,55,249,2,0,2,2,1172
28,5,33,0,0,0,2,1173
7,5,12,1,1,2,2,1174
1276,351,1627,45,13,58,2,1175
213,162,375,4,2,6,2,1176
274,426,700,1,1,2,2,1177
67,7,74,2,0,2,2,1178
634873,180586,815459,4424,1583,6007,2,1179
262,101,363,9,1,10,2,1180
118,52,170,5,1,6,2,1181
72,34,106,5,2,7,2,1182
659,221,880,20,9,29,2,1183
121,91,212,6,5,11,2,1184
0,0,0,-183,-159,-342,2,1185
77,130,207,1,1,2,2,1186
254,381,635,10,13,23,2,1187
249,358,607,14,16,30,2,1188
215,72,287,7,1,8,2,1189
10,6,16,0,1,1,2,1190
54,16,70,1,0,1,2,1191
1064,1916,2980,37,57,94,2,1192
0,0,0,-31,-75,-106,2,1193
144,857,1001,9,13,22,2,1194
1019,1326,2345,30,70,100,2,1195
0,0,0,-310,-267,-577,2,1196
969,1099,2068,30,26,56,2,1197
2639,5213,7852,146,294,440,2,1198
76,124,200,5,4,9,2,1199
115,180,295,11,8,19,2,1200
2314,1691,4005,191,123,314,2,1201
3,4,7,0,0,0,2,1202
8,4,12,0,0,0,2,1203
1,2,3,0,1,1,2,1204
0,0,0,0,0,0,2,1205
1503,1433,2936,45,64,109,2,1206
7,24,31,0,0,0,2,1207
91,31,122,1,1,2,2,1208
132,43,175,3,3,6,2,1209
0,0,0,-731,-464,-1195,2,1210
0,0,0,-47,-50,-97,2,1211
240,52,292,7,0,7,2,1212
113,16,129,0,2,2,2,1213
1537,1922,3459,114,99,213,2,1214
13,13,26,0,0,0,2,1215
163,66,229,0,1,1,2,1216
14,5,19,0,0,0,2,1217
8,3,11,1,0,1,2,1218
5,1,6,1,0,1,2,1219
2,0,2,0,0,0,2,1220
0,0,0,0,0,0,2,1221
2,4,6,0,1,1,2,1222
0,0,0,0,0,0,2,1223
0,0,0,0,0,0,2,1224
0,0,0,0,0,0,2,1225
1,4,5,0,0,0,2,1226
2,0,2,1,0,1,2,1227
8,7,15,2,2,4,2,1228
6,1,7,0,0,0,2,1229
0,1,1,0,0,0,2,1230
0,0,0,0,0,0,2,1231
0,1,1,0,1,1,2,1232
17,14,31,0,0,0,2,1233
1,1,2,0,0,0,2,1234
0,1,1,0,0,0,2,1235
1,2,3,0,0,0,2,1236
1,0,1,0,0,0,2,1237
19,19,38,1,1,2,2,1238
4,1,5,0,0,0,2,1239
8,6,14,0,0,0,2,1240
8,4,12,1,0,1,2,1241
0,0,0,0,0,0,2,1242
2,1,3,2,0,2,2,1243
2,1,3,0,0,0,2,1244
4,6,10,0,0,0,2,1245
0,0,0,0,0,0,2,1246
1,1,2,0,0,0,2,1247
36,33,69,1,0,1,2,1248
5,0,5,0,0,0,2,1249
2,1,3,0,1,1,2,1250
1,0,1,0,0,0,2,1251
2,1,3,0,0,0,2,1252
5,0,5,1,0,1,2,1253
0,0,0,0,0,0,2,1254
39,46,85,1,0,1,2,1255
1,0,1,0,0,0,2,1256
2,1,3,0,0,0,2,1257
0,0,0,0,0,0,2,1258
1,0,1,0,0,0,2,1259
7,7,14,0,0,0,2,1260
33,12,45,0,0,0,2,1261
1,0,1,0,0,0,2,1262
11,4,15,1,0,1,2,1263
0,0,0,0,0,0,2,1264
1,0,1,0,0,0,2,1265
2,0,2,0,0,0,2,1266
5,4,9,1,1,2,2,1267
6,10,16,0,0,0,2,1268
5,0,5,0,0,0,2,1269
0,0,0,0,0,0,2,1270
6,0,6,1,0,1,2,1271
2,0,2,0,0,0,2,1272
13,13,26,0,1,1,2,1273
1,0,1,0,0,0,2,1274
1,1,2,0,0,0,2,1275
1,2,3,0,0,0,2,1276
4,1,5,0,0,0,2,1277
0,0,0,0,0,0,2,1278
1,1,2,0,0,0,2,1279
1,0,1,0,0,0,2,1280
0,0,0,0,0,0,2,1281
0,5,5,0,0,0,2,1282
8,3,11,1,1,2,2,1283
4,0,4,0,0,0,2,1284
0,1,1,0,0,0,2,1285
0,1,1,0,1,1,2,1286
0,0,0,0,0,0,2,1287
3,2,5,0,1,1,2,1288
3,0,3,0,0,0,2,1289
15,18,33,0,0,0,2,1290
0,2,2,0,0,0,2,1291
3,1,4,1,0,1,2,1292
4,2,6,0,0,0,2,1293
1,0,1,0,0,0,2,1294
2,3,5,0,1,1,2,1295
3,2,5,0,0,0,2,1296
0,0,0,0,0,0,2,1297
3,1,4,0,0,0,2,1298
13,4,17,0,0,0,2,1299
0,0,0,0,0,0,2,1300
0,0,0,0,0,0,2,1301
5,9,14,0,1,1,2,1302
3,3,6,0,0,0,2,1303
3,2,5,0,0,0,2,1304
5,0,5,0,0,0,2,1305
0,1,1,0,1,1,2,1306
2,4,6,0,0,0,2,1307
2,2,4,1,0,1,2,1308
5,4,9,0,0,0,2,1309
3,4,7,0,1,1,2,1310
0,2,2,0,0,0,2,1311
0,10,10,0,2,2,2,1312
1,0,1,0,0,0,2,1313
1,0,1,0,0,0,2,1314
0,0,0,0,0,0,2,1315
1,0,1,0,0,0,2,1316
0,0,0,0,0,0,2,1317
4,4,8,0,0,0,2,1318
6,2,8,0,0,0,2,1319
0,0,0,0,0,0,2,1320
2,0,2,1,0,1,2,1321
0,1,1,0,0,0,2,1322
0,0,0,0,0,0,2,1323
5,0,5,0,0,0,2,1324
0,2,2,0,0,0,2,1325
1,1,2,0,0,0,2,1326
7,0,7,0,0,0,2,1327
8,4,12,0,0,0,2,1328
1,0,1,0,0,0,2,1329
1,0,1,0,0,0,2,1330
4,2,6,0,0,0,2,1331
2,0,2,0,0,0,2,1332
1,0,1,0,0,0,2,1333
2,0,2,0,0,0,2,1334
2,1,3,0,0,0,2,1335
2,1,3,0,0,0,2,1336
4,6,10,0,0,0,2,1337
2,3,5,0,0,0,2,1338
1,1,2,0,0,0,2,1339
3,5,8,0,0,0,2,1340
8,0,8,0,0,0,2,1341
1,0,1,0,0,0,2,1342
0,1,1,0,0,0,2,1343
2,2,4,0,0,0,2,1344
2,0,2,0,0,0,2,1345
0,0,0,0,0,0,2,1346
0,0,0,0,0,0,2,1347
0,3,3,0,0,0,2,1348
1,4,5,0,1,1,2,1349
3,3,6,0,0,0,2,1350
4,6,10,0,1,1,2,1351
0,0,0,0,0,0,2,1352
0,0,0,0,0,0,2,1353
5,2,7,1,0,1,2,1354
0,0,0,0,0,0,2,1355
1,1,2,0,0,0,2,1356
0,1,1,0,0,0,2,1357
2,2,4,1,0,1,2,1358
4,0,4,1,0,1,2,1359
5,3,8,0,2,2,2,1360
22,23,45,0,0,0,2,1361
1,2,3,0,0,0,2,1362
4,4,8,0,0,0,2,1363
1,1,2,0,0,0,2,1364
0,0,0,0,0,0,2,1365
2,1,3,0,0,0,2,1366
3,3,6,1,0,1,2,1367
0,1,1,0,0,0,2,1368
2,1,3,0,0,0,2,1369
0,0,0,0,0,0,2,1370
5,0,5,0,0,0,2,1371
1,0,1,0,0,0,2,1372
2,0,2,0,0,0,2,1373
6,6,12,0,0,0,2,1374
1,1,2,0,0,0,2,1375
1,0,1,0,0,0,2,1376
1,0,1,0,0,0,2,1377
0,0,0,0,0,0,2,1378
0,0,0,0,0,0,2,1379
0,0,0,0,0,0,2,1380
0,0,0,0,0,0,2,1381
4,0,4,0,0,0,2,1382
36,26,62,0,0,0,2,1383
2,2,4,0,0,0,2,1384
4,0,4,0,0,0,2,1385
3,2,5,0,0,0,2,1386
4,0,4,0,0,0,2,1387
2,4,6,0,0,0,2,1388
3,4,7,0,0,0,2,1389
2,0,2,1,0,1,2,1390
5,3,8,0,0,0,2,1391
2,0,2,0,0,0,2,1392
3,1,4,0,0,0,2,1393
1,1,2,0,0,0,2,1394
23,91,114,1,2,3,2,1395
2,0,2,1,0,1,2,1396
2,2,4,0,0,0,2,1397
0,0,0,0,0,0,2,1398
5,5,10,0,0,0,2,1399
2,0,2,1,0,1,2,1400
4,1,5,1,0,1,2,1401
3,0,3,0,0,0,2,1402
12,8,20,2,2,4,2,1403
1,3,4,0,1,1,2,1404
2,7,9,0,1,1,2,1405
4,0,4,0,0,0,2,1406
3,3,6,0,0,0,2,1407
6,0,6,0,0,0,2,1408
1,2,3,0,0,0,2,1409
1,0,1,0,0,0,2,1410
6,1,7,0,0,0,2,1411
6,3,9,0,0,0,2,1412
2,4,6,1,0,1,2,1413
2,6,8,0,0,0,2,1414
3,0,3,0,0,0,2,1415
4,5,9,0,0,0,2,1416
1,0,1,0,0,0,2,1417
5,21,26,0,1,1,2,1418
9,2,11,0,0,0,2,1419
6,5,11,0,1,1,2,1420
3,5,8,0,0,0,2,1421
1,0,1,0,0,0,2,1422
1,2,3,0,0,0,2,1423
22,11,33,0,0,0,2,1424
5,14,19,0,0,0,2,1425
139,166,305,8,7,15,2,1426
1,1,2,0,0,0,2,1427
1,1,2,0,0,0,2,1428
0,0,0,0,0,0,2,1429
5,1,6,1,0,1,2,1430
1,0,1,0,0,0,2,1431
0,1,1,0,1,1,2,1432
1,5,6,0,0,0,2,1433
2,0,2,0,0,0,2,1434
0,1,1,0,0,0,2,1435
5,2,7,0,0,0,2,1436
0,5,5,0,2,2,2,1437
3,2,5,0,0,0,2,1438
3,2,5,0,0,0,2,1439
3,0,3,0,0,0,2,1440
7,0,7,0,0,0,2,1441
2,2,4,0,0,0,2,1442
2,3,5,0,1,1,2,1443
4,0,4,1,0,1,2,1444
2,3,5,0,0,0,2,1445
0,1,1,0,0,0,2,1446
1,2,3,1,0,1,2,1447
0,0,0,0,0,0,2,1448
5,1,6,0,0,0,2,1449
0,1,1,0,1,1,2,1450
3,2,5,0,0,0,2,1451
0,0,0,0,0,0,2,1452
1,0,1,0,0,0,2,1453
3,1,4,0,1,1,2,1454
23,13,36,1,0,1,2,1455
3,3,6,0,0,0,2,1456
2,0,2,0,0,0,2,1457
2,0,2,0,0,0,2,1458
0,2,2,0,0,0,2,1459
1,2,3,0,0,0,2,1460
0,0,0,0,0,0,2,1461
4,1,5,0,0,0,2,1462
23,18,41,0,0,0,2,1463
0,1,1,0,0,0,2,1464
1,1,2,0,0,0,2,1465
4,1,5,1,1,2,2,1466
0,0,0,0,0,0,2,1467
4,0,4,1,0,1,2,1468
5,2,7,2,0,2,2,1469
5,1,6,0,0,0,2,1470
1,0,1,0,0,0,2,1471
2,2,4,0,0,0,2,1472
2,0,2,0,0,0,2,1473
2,4,6,0,0,0,2,1474
2,5,7,0,0,0,2,1475
46,5,51,1,1,2,2,1476
3,1,4,0,0,0,2,1477
2,4,6,0,0,0,2,1478
1,3,4,0,0,0,2,1479
1,0,1,0,0,0,2,1480
1,0,1,0,0,0,2,1481
3,2,5,2,0,2,2,1482
14,18,32,1,4,5,2,1483
9,1,10,0,0,0,2,1484
5,1,6,0,0,0,2,1485
1,3,4,0,0,0,2,1486
195,116,311,39,13,52,2,1487
1,0,1,0,0,0,2,1488
0,0,0,0,0,0,2,1489
3,0,3,0,0,0,2,1490
1,0,1,0,0,0,2,1491
4,1,5,0,0,0,2,1492
4,1,5,0,0,0,2,1493
2,4,6,0,0,0,2,1494
0,0,0,0,0,0,2,1495
9,2,11,0,0,0,2,1496
1,1,2,0,0,0,2,1497
4,0,4,1,0,1,2,1498
2,0,2,0,0,0,2,1499
23,3,26,0,0,0,2,1500
6,0,6,0,0,0,2,1501
4,0,4,0,0,0,2,1502
5,1,6,0,0,0,2,1503
4,0,4,0,0,0,2,1504
9,1,10,0,1,1,2,1505
1,0,1,0,0,0,2,1506
4,1,5,0,0,0,2,1507
11,2,13,0,0,0,2,1508
2,1,3,0,0,0,2,1509
2,0,2,1,0,1,2,1510
0,1,1,0,0,0,2,1511
5,7,12,0,0,0,2,1512
2,5,7,0,0,0,2,1513
0,0,0,-2,0,-2,2,1514
22,7,29,0,0,0,2,1515
0,0,0,0,0,0,2,1516
18,5,23,1,1,2,2,1517
1,0,1,0,0,0,2,1518
45,22,67,0,0,0,2,1519
2,1,3,0,0,0,2,1520
0,0,0,0,0,0,2,1521
3,5,8,0,0,0,2,1522
3,8,11,1,0,1,2,1523
0,0,0,0,0,0,2,1524
3,0,3,0,0,0,2,1525
2,0,2,0,0,0,2,1526
0,1,1,0,0,0,2,1527
5,8,13,0,0,0,2,1528
3,2,5,0,0,0,2,1529
0,0,0,-234,-240,-474,2,1530
2,1,3,0,0,0,2,1531
5,1,6,0,0,0,2,1532
2,2,4,0,1,1,2,1533
2,0,2,1,0,1,2,1534
0,0,0,0,0,0,2,1535
0,0,0,0,0,0,2,1536
0,1,1,0,0,0,2,1537
2,2,4,0,0,0,2,1538
0,0,0,-5,-1,-6,2,1539
3,2,5,0,0,0,2,1540
0,2,2,0,0,0,2,1541
2,3,5,0,0,0,2,1542
1,1,2,0,0,0,2,1543
1,1,2,0,0,0,2,1544
0,1,1,0,1,1,2,1545
1,1,2,1,0,1,2,1546
3,0,3,0,0,0,2,1547
2,0,2,0,0,0,2,1548
6,1,7,0,0,0,2,1549
25,12,37,0,0,0,2,1550
13,4,17,0,0,0,2,1551
1,0,1,0,0,0,2,1552
3,5,8,0,0,0,2,1553
1,1,2,0,0,0,2,1554
0,0,0,0,0,0,2,1555
3,1,4,0,0,0,2,1556
5,1,6,0,0,0,2,1557
1,0,1,0,0,0,2,1558
2,0,2,1,0,1,2,1559
2,1,3,0,0,0,2,1560
7,0,7,0,0,0,2,1561
2,0,2,0,0,0,2,1562
0,2,2,0,0,0,2,1563
2,0,2,1,0,1,2,1564
2,3,5,1,0,1,2,1565
6,8,14,0,1,1,2,1566
0,0,0,0,0,0,2,1567
6,1,7,0,0,0,2,1568
0,4,4,0,0,0,2,1569
0,2,2,0,0,0,2,1570
4,5,9,0,1,1,2,1571
38,34,72,0,0,0,2,1572
19,12,31,2,0,2,2,1573
7,1,8,0,0,0,2,1574
1,2,3,0,0,0,2,1575
4,4,8,0,0,0,2,1576
0,0,0,0,0,0,2,1577
1,1,2,1,0,1,2,1578
5,1,6,0,0,0,2,1579
0,0,0,0,0,0,2,1580
2,4,6,1,1,2,2,1581
0,2,2,0,0,0,2,1582
2,4,6,0,0,0,2,1583
5,6,11,0,0,0,2,1584
0,0,0,0,0,0,2,1585
1,2,3,0,0,0,2,1586
4,7,11,0,0,0,2,1587
0,1,1,0,0,0,2,1588
1,0,1,0,0,0,2,1589
0,0,0,0,0,0,2,1590
2,0,2,1,0,1,2,1591
1,0,1,0,0,0,2,1592
1,0,1,0,0,0,2,1593
2,5,7,0,0,0,2,1594
1,0,1,0,0,0,2,1595
1,7,8,0,0,0,2,1596
6,1,7,0,0,0,2,1597
2,0,2,0,0,0,2,1598
7,1,8,0,0,0,2,1599
283,89,372,2,2,4,2,1600
19,11,30,0,0,0,2,1601
35,25,60,8,4,12,2,1602
6,0,6,0,0,0,2,1603
1,0,1,0,0,0,2,1604
6,2,8,0,0,0,2,1605
2,0,2,0,0,0,2,1606
8,1,9,0,0,0,2,1607
1,4,5,0,0,0,2,1608
0,0,0,0,0,0,2,1609
2,0,2,0,0,0,2,1610
0,0,0,0,0,0,2,1611
0,0,0,0,0,0,2,1612
1,0,1,0,0,0,2,1613
6,0,6,0,0,0,2,1614
2,0,2,0,0,0,2,1615
0,0,0,0,0,0,2,1616
4,0,4,1,0,1,2,1617
4,13,17,0,0,0,2,1618
3,2,5,0,0,0,2,1619
4,3,7,0,0,0,2,1620
3,1,4,0,0,0,2,1621
1,0,1,0,0,0,2,1622
2,2,4,0,0,0,2,1623
0,0,0,0,0,0,2,1624
2,2,4,0,0,0,2,1625
4,2,6,0,0,0,2,1626
3,0,3,0,0,0,2,1627
1,7,8,0,0,0,2,1628
2,1,3,0,0,0,2,1629
2,3,5,0,0,0,2,1630
2,0,2,0,0,0,2,1631
2,0,2,0,0,0,2,1632
4,0,4,0,0,0,2,1633
3,0,3,0,0,0,2,1634
0,0,0,0,0,0,2,1635
4,3,7,0,0,0,2,1636
3,1,4,1,0,1,2,1637
1,1,2,0,0,0,2,1638
4,1,5,0,0,0,2,1639
0,0,0,-4,0,-4,2,1640
2,2,4,0,0,0,2,1641
0,2,2,0,0,0,2,1642
2,1,3,0,0,0,2,1643
0,0,0,0,0,0,2,1644
9,5,14,0,0,0,2,1645
0,0,0,0,0,0,2,1646
0,2,2,0,1,1,2,1647
0,0,0,0,0,0,2,1648
4,3,7,0,0,0,2,1649
8,1,9,0,0,0,2,1650
17,7,24,0,0,0,2,1651
7,2,9,0,0,0,2,1652
1,1,2,0,0,0,2,1653
1,0,1,0,0,0,2,1654
1,1,2,0,0,0,2,1655
1,0,1,0,0,0,2,1656
3,2,5,0,0,0,2,1657
0,0,0,0,0,0,2,1658
7,2,9,0,0,0,2,1659
1,2,3,1,0,1,2,1660
1,0,1,1,0,1,2,1661
2,0,2,1,0,1,2,1662
0,0,0,-1,-2,-3,2,1663
2,0,2,0,0,0,2,1664
6,8,14,0,3,3,2,1665
1,0,1,0,0,0,2,1666
0,0,0,0,0,0,2,1667
4,1,5,0,0,0,2,1668
6,2,8,0,0,0,2,1669
6,2,8,0,0,0,2,1670
1,0,1,0,0,0,2,1671
0,0,0,0,0,0,2,1672
5,2,7,0,0,0,2,1673
5,2,7,0,0,0,2,1674
13,5,18,0,1,1,2,1675
1,0,1,0,0,0,2,1676
5,7,12,0,1,1,2,1677
2,0,2,0,0,0,2,1678
8,3,11,0,0,0,2,1679
0,0,0,0,0,0,2,1680
2,2,4,0,0,0,2,1681
1,2,3,0,0,0,2,1682
0,4,4,0,0,0,2,1683
53,84,137,0,0,0,2,1684
15,77,92,0,4,4,2,1685
1,2,3,0,0,0,2,1686
0,2,2,0,0,0,2,1687
62,49,111,1,2,3,2,1688
1,1,2,1,0,1,2,1689
0,1,1,0,0,0,2,1690
0,0,0,-2,-1,-3,2,1691
9,3,12,0,0,0,2,1692
1,2,3,0,0,0,2,1693
1,2,3,0,0,0,2,1694
70,98,168,3,3,6,2,1695
0,0,0,0,0,0,2,1696
1,0,1,0,0,0,2,1697
2,0,2,0,0,0,2,1698
0,2,2,0,0,0,2,1699
7,11,18,0,0,0,2,1700
1,1,2,0,0,0,2,1701
0,4,4,0,0,0,2,1702
1,1,2,0,0,0,2,1703
121,65,186,5,2,7,2,1704
5,4,9,0,0,0,2,1705
3,2,5,0,0,0,2,1706
0,0,0,0,0,0,2,1707
16,16,32,0,1,1,2,1708
3,5,8,0,0,0,2,1709
0,2,2,0,0,0,2,1710
7,2,9,2,0,2,2,1711
2,1,3,0,0,0,2,1712
2,0,2,0,0,0,2,1713
2,0,2,0,0,0,2,1714
3,0,3,1,0,1,2,1715
74,36,110,9,1,10,2,1716
0,0,0,0,0,0,2,1717
0,1,1,0,0,0,2,1718
0,2,2,0,0,0,2,1719
7,2,9,5,2,7,2,1720
2,1,3,0,0,0,2,1721
10,21,31,0,0,0,2,1722
0,0,0,0,0,0,2,1723
4,1,5,0,1,1,2,1724
2,1,3,0,0,0,2,1725
3,2,5,0,1,1,2,1726
6,2,8,0,0,0,2,1727
33,8,41,0,0,0,2,1728
2,3,5,0,0,0,2,1729
0,0,0,0,0,0,2,1730
1,1,2,0,0,0,2,1731
0,0,0,0,0,0,2,1732
1,1,2,0,0,0,2,1733
2,0,2,0,0,0,2,1734
1,0,1,0,0,0,2,1735
2,2,4,0,0,0,2,1736
2,0,2,0,0,0,2,1737
4,3,7,0,0,0,2,1738
2,1,3,0,0,0,2,1739
0,1,1,0,0,0,2,1740
7,2,9,0,0,0,2,1741
6,2,8,0,0,0,2,1742
1,0,1,0,0,0,2,1743
1,0,1,0,0,0,2,1744
0,0,0,0,0,0,2,1745
1,0,1,0,0,0,2,1746
0,0,0,-3,0,-3,2,1747
0,1,1,0,0,0,2,1748
0,3,3,0,0,0,2,1749
0,1,1,0,1,1,2,1750
2,1,3,0,0,0,2,1751
0,0,0,0,0,0,2,1752
7,7,14,0,0,0,2,1753
109,131,240,1,2,3,2,1754
3,3,6,0,0,0,2,1755
1,1,2,0,0,0,2,1756
0,0,0,0,0,0,2,1757
2,0,2,0,0,0,2,1758
5,8,13,1,2,3,2,1759
3,0,3,0,0,0,2,1760
6,2,8,0,0,0,2,1761
0,0,0,-4,0,-4,2,1762
1,2,3,0,0,0,2,1763
2,2,4,0,0,0,2,1764
0,1,1,0,0,0,2,1765
3,1,4,1,0,1,2,1766
1,0,1,0,0,0,2,1767
0,1,1,0,0,0,2,1768
0,0,0,0,0,0,2,1769
4,0,4,0,0,0,2,1770
10,12,22,1,1,2,2,1771
4,0,4,1,0,1,2,1772
0,2,2,0,0,0,2,1773
1,1,2,0,0,0,2,1774
12,25,37,1,2,3,2,1775
9,8,17,0,0,0,2,1776
4,1,5,1,0,1,2,1777
0,1,1,0,0,0,2,1778
3,0,3,0,0,0,2,1779
2,0,2,0,0,0,2,1780
1,1,2,0,0,0,2,1781
3,0,3,0,0,0,2,1782
1,0,1,0,0,0,2,1783
5,3,8,0,0,0,2,1784
35,12,47,0,0,0,2,1785
1,3,4,1,1,2,2,1786
7,2,9,0,0,0,2,1787
1,0,1,0,0,0,2,1788
0,1,1,0,0,0,2,1789
3,2,5,0,0,0,2,1790
0,4,4,0,0,0,2,1791
1,1,2,0,0,0,2,1792
0,0,0,0,0,0,2,1793
1,2,3,0,0,0,2,1794
0,0,0,0,0,0,2,1795
150,60,210,7,2,9,2,1796
4,0,4,1,0,1,2,1797
0,0,0,0,0,0,2,1798
21,3,24,0,0,0,2,1799
20,9,29,0,0,0,2,1800
1,3,4,0,0,0,2,1801
1,1,2,0,0,0,2,1802
6,1,7,0,0,0,2,1803
3,2,5,0,0,0,2,1804
16,3,19,1,0,1,2,1805
0,0,0,0,0,0,2,1806
5,4,9,0,0,0,2,1807
9,6,15,0,0,0,2,1808
0,0,0,0,0,0,2,1809
1,0,1,0,0,0,2,1810
0,1,1,0,0,0,2,1811
0,0,0,0,0,0,2,1812
0,2,2,0,0,0,2,1813
6,18,24,0,0,0,2,1814
0,1,1,0,0,0,2,1815
6,7,13,0,0,0,2,1816
1,0,1,0,0,0,2,1817
3,1,4,0,0,0,2,1818
3,5,8,0,0,0,2,1819
1,3,4,0,0,0,2,1820
8,18,26,0,0,0,2,1821
0,5,5,0,1,1,2,1822
75,33,108,0,0,0,2,1823
5,1,6,0,0,0,2,1824
6,1,7,0,0,0,2,1825
8,3,11,0,1,1,2,1826
0,3,3,0,0,0,2,1827
5,1,6,0,0,0,2,1828
0,0,0,0,0,0,2,1829
11,9,20,1,1,2,2,1830
0,1,1,0,0,0,2,1831
1,0,1,0,0,0,2,1832
0,0,0,0,0,0,2,1833
5,2,7,0,0,0,2,1834
2,0,2,0,0,0,2,1835
4,1,5,0,0,0,2,1836
1,0,1,0,0,0,2,1837
2,0,2,0,0,0,2,1838
1,1,2,0,0,0,2,1839
16,12,28,0,0,0,2,1840
5,2,7,0,0,0,2,1841
1,4,5,0,0,0,2,1842
11,7,18,0,0,0,2,1843
0,0,0,0,0,0,2,1844
5,6,11,0,0,0,2,1845
0,1,1,0,1,1,2,1846
0,1,1,0,1,1,2,1847
5,0,5,0,0,0,2,1848
31,12,43,0,0,0,2,1849
1,0,1,1,0,1,2,1850
2,0,2,0,0,0,2,1851
0,0,0,0,0,0,2,1852
3,1,4,0,0,0,2,1853
7,4,11,0,0,0,2,1854
3,2,5,0,0,0,2,1855
4,0,4,0,0,0,2,1856
3,3,6,1,1,2,2,1857
8,5,13,0,1,1,2,1858
0,1,1,0,0,0,2,1859
0,0,0,0,0,0,2,1860
0,0,0,0,0,0,2,1861
1,0,1,0,0,0,2,1862
0,0,0,0,0,0,2,1863
2,0,2,0,0,0,2,1864
0,0,0,-4,0,-4,2,1865
1,0,1,1,0,1,2,1866
2,2,4,0,0,0,2,1867
3,1,4,0,0,0,2,1868
1,0,1,0,0,0,2,1869
19,35,54,1,1,2,2,1870
0,0,0,0,0,0,2,1871
8,3,11,1,1,2,2,1872
4,0,4,0,0,0,2,1873
2,1,3,0,0,0,2,1874
5,1,6,0,0,0,2,1875
1,0,1,0,0,0,2,1876
0,1,1,0,0,0,2,1877
1,1,2,0,0,0,2,1878
4,6,10,0,1,1,2,1879
6,1,7,0,0,0,2,1880
1,3,4,0,0,0,2,1881
4,0,4,0,0,0,2,1882
0,1,1,0,1,1,2,1883
20,11,31,0,0,0,2,1884
1,0,1,0,0,0,2,1885
0,1,1,0,0,0,2,1886
26,7,33,8,0,8,2,1887
12,7,19,0,0,0,2,1888
6,3,9,0,1,1,2,1889
0,0,0,0,0,0,2,1890
6,2,8,0,0,0,2,1891
7,2,9,0,0,0,2,1892
2,3,5,0,0,0,2,1893
7,1,8,0,0,0,2,1894
2,0,2,0,0,0,2,1895
6,21,27,0,0,0,2,1896
7,1,8,0,0,0,2,1897
1,1,2,0,0,0,2,1898
1,3,4,0,0,0,2,1899
4,3,7,0,1,1,2,1900
4,3,7,0,0,0,2,1901
0,0,0,-5,-1,-6,2,1902
0,0,0,0,0,0,2,1903
11,13,24,0,0,0,2,1904
1,0,1,0,0,0,2,1905
3,1,4,0,0,0,2,1906
4,0,4,0,0,0,2,1907
1,6,7,0,0,0,2,1908
1,1,2,0,0,0,2,1909
0,1,1,0,0,0,2,1910
2,3,5,0,0,0,2,1911
2,0,2,0,0,0,2,1912
6,0,6,1,0,1,2,1913
11,0,11,0,0,0,2,1914
5,0,5,0,0,0,2,1915
3,0,3,1,0,1,2,1916
2,1,3,0,0,0,2,1917
4,12,16,0,2,2,2,1918
57,23,80,8,2,10,2,1919
1,1,2,0,0,0,2,1920
2,5,7,0,1,1,2,1921
3,0,3,0,0,0,2,1922
16,9,25,1,0,1,2,1923
65,45,110,0,0,0,2,1924
7,2,9,0,0,0,2,1925
1,2,3,1,0,1,2,1926
19,10,29,1,0,1,2,1927
2,0,2,0,0,0,2,1928
3,2,5,1,0,1,2,1929
3,0,3,0,0,0,2,1930
5,2,7,1,0,1,2,1931
10,3,13,0,0,0,2,1932
13,5,18,1,0,1,2,1933
1,4,5,0,0,0,2,1934
1,0,1,0,0,0,2,1935
4,4,8,0,1,1,2,1936
3,1,4,0,0,0,2,1937
10,3,13,0,0,0,2,1938
6,10,16,0,0,0,2,1939
4,2,6,0,0,0,2,1940
4,4,8,0,0,0,2,1941
15,4,19,0,0,0,2,1942
4,2,6,0,0,0,2,1943
13,4,17,0,0,0,2,1944
0,3,3,0,0,0,2,1945
2,4,6,0,2,2,2,1946
2,4,6,0,0,0,2,1947
7,6,13,0,0,0,2,1948
1,4,5,0,0,0,2,1949
11,9,20,1,1,2,2,1950
37,29,66,1,6,7,2,1951
15,11,26,0,0,0,2,1952
0,0,0,0,0,0,2,1953
0,0,0,0,0,0,2,1954
1,1,2,0,0,0,2,1955
3,4,7,0,0,0,2,1956
7,2,9,0,0,0,2,1957
2,5,7,0,0,0,2,1958
2,1,3,0,0,0,2,1959
2,0,2,0,0,0,2,1960
1,1,2,0,0,0,2,1961
1,0,1,0,0,0,2,1962
2,4,6,0,0,0,2,1963
2,1,3,0,0,0,2,1964
0,0,0,0,0,0,2,1965
10,5,15,0,1,1,2,1966
1,0,1,0,0,0,2,1967
1,0,1,0,0,0,2,1968
3,5,8,0,0,0,2,1969
0,2,2,0,0,0,2,1970
0,0,0,0,0,0,2,1971
80,22,102,2,2,4,2,1972
6,0,6,0,0,0,2,1973
6,3,9,0,0,0,2,1974
0,0,0,0,0,0,2,1975
7,0,7,0,0,0,2,1976
2,4,6,0,0,0,2,1977
15,23,38,0,2,2,2,1978
2358,3207,5565,134,187,321,2,1979
1209,2159,3368,15,48,63,2,1980
179,108,287,10,3,13,2,1981
512,1462,1974,36,111,147,2,1982
943,2725,3668,26,102,128,2,1983
30,57,87,0,2,2,2,1984
15,31,46,0,0,0,2,1985
1280,1231,2511,56,52,108,2,1986
2234,5103,7337,79,139,218,2,1987
14,5,19,0,1,1,2,1988
128,62,190,10,1,11,2,1989
327,240,567,8,7,15,2,1990
62,8,70,4,0,4,2,1991
78,94,172,3,5,8,2,1992
73,144,217,5,7,12,2,1993
191,254,445,9,11,20,2,1994
364,283,647,21,19,40,2,1995
62,74,136,1,0,1,2,1996
119,178,297,16,25,41,2,1997
7,14,21,0,0,0,2,1998
6,15,21,0,0,0,2,1999
17,10,27,0,0,0,2,2000
32,2,34,0,0,0,2,2001
4,1,5,0,0,0,2,2002
38,4,42,0,0,0,2,2003
12,7,19,0,1,1,2,2004
3,6,9,0,0,0,2,2005
0,2,2,0,0,0,2,2006
0,0,0,0,0,0,2,2007
2,0,2,0,0,0,2,2008
18,13,31,1,3,4,2,2009
3,2,5,0,0,0,2,2010
0,1,1,0,0,0,2,2011
1,0,1,0,0,0,2,2012
1,5,6,0,0,0,2,2013
3196,3111,6307,90,59,149,2,2014
458,508,966,12,14,26,2,2015
246,190,436,3,4,7,2,2016
219,178,397,3,5,8,2,2017
83,56,139,4,2,6,2,2018
0,0,0,-26,-63,-89,2,2019
14,9,23,3,0,3,2,2020
60,38,98,0,4,4,2,2021
137,193,330,8,7,15,2,2022
0,0,0,-355,-317,-672,2,2023
187,172,359,17,11,28,2,2024
390,334,724,39,31,70,2,2025
16,5,21,1,0,1,2,2026
11,9,20,3,1,4,2,2027
1,2,3,0,0,0,2,2028
0,2,2,0,0,0,2,2029
129,41,170,7,6,13,2,2030
15,5,20,0,0,0,2,2031
11,7,18,0,0,0,2,2032
1,4,5,0,0,0,2,2033
59,108,167,2,1,3,2,2034
34,21,55,1,1,2,2,2035
20,12,32,0,0,0,2,2036
4,2,6,0,0,0,2,2037
9,6,15,0,0,0,2,2038
6,8,14,0,0,0,2,2039
2,2,4,0,0,0,2,2040
25,12,37,0,0,0,2,2041
2,2,4,0,0,0,2,2042
21,23,44,1,1,2,2,2043
2292,5256,7548,121,201,322,2,2044
70,54,124,1,2,3,2,2045
9,7,16,2,2,4,2,2046
1,2,3,0,0,0,2,2047
2,0,2,0,0,0,2,2048
3,1,4,0,0,0,2,2049
2,2,4,0,0,0,2,2050
0,4,4,0,0,0,2,2051
407,439,846,156,155,311,2,2052
96,87,183,28,21,49,2,2053
103,166,269,38,41,79,2,2054
135,205,340,30,20,50,2,2055
486,379,865,301,307,608,2,2056
25,21,46,5,9,14,2,2057
0,0,0,0,0,0,2,2058
5,1,6,1,0,1,2,2059
1,4,5,0,0,0,2,2060
0,1,1,0,0,0,2,2061
2,0,2,0,0,0,2,2062
14,43,57,2,8,10,2,2063
0,1,1,0,0,0,2,2064
2,2,4,0,0,0,2,2065
13,3,16,0,0,0,2,2066
6,8,14,0,0,0,2,2067
40,104,144,3,5,8,2,2068
12,21,33,0,1,1,2,2069
0,1,1,0,0,0,2,2070
4,4,8,0,1,1,2,2071
1,2,3,0,0,0,2,2072
0,1,1,0,0,0,2,2073
90,403,493,10,27,37,2,2074
1,2,3,0,0,0,2,2075
2,0,2,0,0,0,2,2076
0,0,0,0,0,0,2,2077
0,4,4,0,0,0,2,2078
11,5,16,0,0,0,2,2079
16,36,52,0,2,2,2,2080
6718,11987,18705,321,517,838,2,2081
0,0,0,0,0,0,2,2082
0,1,1,0,0,0,2,2083
0,0,0,0,0,0,2,2084
0,1,1,0,0,0,2,2085
0,0,0,0,0,0,2,2086
0,1,1,0,0,0,2,2087
9,13,22,0,1,1,2,2088
1,0,1,0,0,0,2,2089
2,12,14,0,2,2,2,2090
1,2,3,0,0,0,2,2091
2,4,6,0,0,0,2,2092
0,0,0,0,0,0,2,2093
0,2,2,0,0,0,2,2094
0,0,0,0,0,0,2,2095
0,0,0,0,0,0,2,2096
0,1,1,0,0,0,2,2097
0,0,0,0,0,0,2,2098
0,1,1,0,0,0,2,2099
1,4,5,0,0,0,2,2100
2,0,2,0,0,0,2,2101
0,0,0,0,0,0,2,2102
1,0,1,0,0,0,2,2103
0,0,0,0,0,0,2,2104
3,5,8,1,2,3,2,2105
0,0,0,0,0,0,2,2106
0,1,1,0,0,0,2,2107
1,0,1,0,0,0,2,2108
0,1,1,0,0,0,2,2109
1,2,3,1,1,2,2,2110
5,31,36,1,3,4,2,2111
0,0,0,0,0,0,2,2112
0,0,0,0,0,0,2,2113
1,1,2,0,0,0,2,2114
0,0,0,0,0,0,2,2115
0,0,0,0,0,0,2,2116
2,2,4,0,0,0,2,2117
0,0,0,0,0,0,2,2118
0,0,0,0,0,0,2,2119
1,0,1,0,0,0,2,2120
0,0,0,0,0,0,2,2121
0,1,1,0,0,0,2,2122
0,0,0,0,0,0,2,2123
1,0,1,0,0,0,2,2124
0,2,2,0,0,0,2,2125
0,0,0,0,0,0,2,2126
0,0,0,0,0,0,2,2127
0,0,0,0,0,0,2,2128
0,2,2,0,0,0,2,2129
0,2,2,0,0,0,2,2130
0,0,0,0,0,0,2,2131
0,1,1,0,0,0,2,2132
0,1,1,0,0,0,2,2133
0,0,0,0,0,0,2,2134
0,0,0,0,0,0,2,2135
2,2,4,0,0,0,2,2136
1,0,1,0,0,0,2,2137
0,1,1,0,0,0,2,2138
0,0,0,0,0,0,2,2139
0,0,0,0,0,0,2,2140
40,31,71,1,0,1,2,2141
141,109,250,7,8,15,2,2142
15,5,20,0,0,0,2,2143
5,3,8,0,0,0,2,2144
23,7,30,1,1,2,2,2145
15,4,19,0,0,0,2,2146
47,55,102,3,2,5,2,2147
28,54,82,2,2,4,2,2148
11,32,43,0,0,0,2,2149
255,440,695,17,40,57,2,2150
84,180,264,7,8,15,2,2151
24,56,80,0,1,1,2,2152
47,25,72,0,1,1,2,2153
125,112,237,6,3,9,2,2154
87,89,176,4,6,10,2,2155
13,11,24,1,0,1,2,2156
13,16,29,1,0,1,2,2157
1,6,7,1,2,3,2,2158
11,5,16,0,0,0,2,2159
18,8,26,2,0,2,2,2160
12,17,29,0,0,0,2,2161
76,57,133,1,1,2,2,2162
29,17,46,1,1,2,2,2163
63,153,216,5,6,11,2,2164
38,42,80,0,1,1,2,2165
94,85,179,3,4,7,2,2166
78,45,123,6,3,9,2,2167
52,22,74,0,0,0,2,2168
32,4,36,0,0,0,2,2169
5,1,6,0,0,0,2,2170
8,13,21,0,1,1,2,2171
475,520,995,7,9,16,2,2172
10,4,14,2,0,2,2,2173
11,50,61,0,0,0,2,2174
14,1,15,0,1,1,2,2175
24,7,31,2,1,3,2,2176
3,2,5,0,0,0,2,2177
58,10,68,7,1,8,2,2178
1,0,1,0,0,0,2,2179
1,0,1,0,0,0,2,2180
2,2,4,0,0,0,2,2181
6,3,9,0,0,0,2,2182
2,2,4,0,0,0,2,2183
4,2,6,0,0,0,2,2184
0,1,1,0,0,0,2,2185
8,8,16,0,0,0,2,2186
0,6,6,0,0,0,2,2187
12,7,19,0,0,0,2,2188
4,1,5,0,0,0,2,2189
4,3,7,0,0,0,2,2190
5,7,12,0,0,0,2,2191
3,1,4,0,0,0,2,2192
0,3,3,0,0,0,2,2193
2,7,9,0,1,1,2,2194
10,1,11,0,0,0,2,2195
3,3,6,0,0,0,2,2196
12,6,18,0,0,0,2,2197
46,30,76,4,1,5,2,2198
95,44,139,5,1,6,2,2199
642,243,885,14,1,15,2,2200
89,33,122,1,0,1,2,2201
10,3,13,1,0,1,2,2202
1,0,1,0,0,0,2,2203
12,3,15,0,0,0,2,2204
5,4,9,0,0,0,2,2205
0,0,0,0,0,0,2,2206
4,1,5,0,0,0,2,2207
0,1,1,0,0,0,2,2208
2,0,2,1,0,1,2,2209
7,2,9,1,0,1,2,2210
6,6,12,0,0,0,2,2211
3,2,5,0,0,0,2,2212
16,15,31,0,2,2,2,2213
7,5,12,0,1,1,2,2214
0,3,3,0,0,0,2,2215
3,0,3,0,0,0,2,2216
2,0,2,0,0,0,2,2217
2,2,4,0,0,0,2,2218
1,2,3,0,0,0,2,2219
1,0,1,0,0,0,2,2220
0,9,9,0,0,0,2,2221
7,1,8,0,0,0,2,2222
5,0,5,0,0,0,2,2223
2,5,7,0,0,0,2,2224
0,1,1,0,0,0,2,2225
2,1,3,0,0,0,2,2226
1,3,4,0,0,0,2,2227
17,3,20,0,0,0,2,2228
6,2,8,0,0,0,2,2229
1,1,2,0,0,0,2,2230
4,17,21,0,0,0,2,2231
1,1,2,0,0,0,2,2232
9,1,10,0,0,0,2,2233
1,0,1,0,0,0,2,2234
5,1,6,0,0,0,2,2235
4,1,5,0,0,0,2,2236
1,3,4,0,0,0,2,2237
1,0,1,0,0,0,2,2238
2,0,2,0,0,0,2,2239
0,1,1,0,0,0,2,2240
1,0,1,0,0,0,2,2241
0,0,0,0,0,0,2,2242
5,6,11,0,0,0,2,2243
0,1,1,0,0,0,2,2244
2,1,3,0,0,0,2,2245
4,0,4,0,0,0,2,2246
4,15,19,1,1,2,2,2247
1,1,2,0,0,0,2,2248
7,1,8,0,0,0,2,2249
4665,9724,14389,69,221,290,2,2250
4,8,12,0,0,0,2,2251
4,3,7,0,0,0,2,2252
0,0,0,0,0,0,2,2253
1,0,1,0,0,0,2,2254
3,3,6,0,0,0,2,2255
0,0,0,0,0,0,2,2256
234,110,344,5,6,11,2,2257
2,8,10,0,0,0,2,2258
3,1,4,0,1,1,2,2259
1,2,3,0,0,0,2,2260
2,0,2,0,0,0,2,2261
2,0,2,0,0,0,2,2262
1,1,2,0,0,0,2,2263
1,0,1,0,0,0,2,2264
0,1,1,0,0,0,2,2265
0,0,0,0,0,0,2,2266
1,0,1,0,0,0,2,2267
0,1,1,0,0,0,2,2268
3,2,5,0,1,1,2,2269
1,4,5,1,0,1,2,2270
1,6,7,0,0,0,2,2271
0,0,0,0,0,0,2,2272
1,0,1,0,0,0,2,2273
15,1,16,1,1,2,2,2274
1,2,3,0,0,0,2,2275
2,5,7,1,0,1,2,2276
0,0,0,0,0,0,2,2277
20,37,57,2,1,3,2,2278
3,2,5,0,0,0,2,2279
12,38,50,0,0,0,2,2280
0,0,0,0,0,0,2,2281
4,0,4,0,0,0,2,2282
0,0,0,0,0,0,2,2283
1,1,2,0,0,0,2,2284
2,1,3,0,0,0,2,2285
1,1,2,0,0,0,2,2286
0,0,0,0,0,0,2,2287
1,0,1,0,0,0,2,2288
3,0,3,0,0,0,2,2289
0,0,0,0,0,0,2,2290
1,0,1,0,0,0,2,2291
4,0,4,0,0,0,2,2292
2,0,2,0,0,0,2,2293
1,1,2,0,0,0,2,2294
0,1,1,0,0,0,2,2295
30,30,60,2,0,2,2,2296
0,0,0,0,0,0,2,2297
139,125,264,5,1,6,2,2298
78,67,145,7,2,9,2,2299
78,47,125,26,6,32,2,2300
8,4,12,0,0,0,2,2301
2,7,9,0,2,2,2,2302
11,3,14,0,0,0,2,2303
4,0,4,0,0,0,2,2304
5,0,5,0,0,0,2,2305
1,3,4,0,0,0,2,2306
0,1,1,0,0,0,2,2307
8,5,13,0,0,0,2,2308
0,1,1,0,0,0,2,2309
1,0,1,1,0,1,2,2310
0,3,3,0,0,0,2,2311
0,0,0,0,0,0,2,2312
0,0,0,0,0,0,2,2313
1,0,1,0,0,0,2,2314
3,0,3,0,0,0,2,2315
43,42,85,10,1,11,2,2316
23,43,66,0,1,1,2,2317
79,172,251,6,14,20,2,2318
3,1,4,0,0,0,2,2319
16,3,19,0,0,0,2,2320
28,5,33,1,1,2,2,2321
1606,1704,3310,28,55,83,2,2322
12,3,15,1,0,1,2,2323
14,4,18,0,2,2,2,2324
8,5,13,0,1,1,2,2325
21,16,37,0,1,1,2,2326
29,11,40,5,0,5,2,2327
19,3,22,1,1,2,2,2328
843,650,1493,18,19,37,2,2329
4142,2374,6516,19,22,41,2,2330
0,4,4,0,0,0,2,2331
48,154,202,5,22,27,2,2332
3,7,10,0,0,0,2,2333
8,24,32,0,1,1,2,2334
2,16,18,0,0,0,2,2335
13,111,124,2,7,9,2,2336
5,21,26,0,1,1,2,2337
222,110,332,5,4,9,2,2338
121,105,226,4,3,7,2,2339
18,10,28,0,0,0,2,2340
16,31,47,1,0,1,2,2341
318,77,395,24,2,26,2,2342
352,98,450,11,8,19,2,2343
127,24,151,9,1,10,2,2344
7,6,13,0,0,0,2,2345
17,6,23,1,1,2,2,2346
13,0,13,0,0,0,2,2347
11,10,21,0,1,1,2,2348
8,4,12,0,0,0,2,2349
12,10,22,0,0,0,2,2350
46,22,68,2,1,3,2,2351
3,0,3,0,0,0,2,2352
94,43,137,0,0,0,2,2353
15,24,39,0,1,1,2,2354
17,9,26,1,0,1,2,2355
8,16,24,0,0,0,2,2356
33,3,36,1,0,1,2,2357
4,3,7,0,0,0,2,2358
3,0,3,0,0,0,2,2359
9,1,10,0,0,0,2,2360
1,2,3,0,0,0,2,2361
37,5,42,0,0,0,2,2362
1516,661,2177,82,29,111,2,2363
763,1061,1824,49,68,117,2,2364
12,9,21,0,0,0,2,2365
11,24,35,1,0,1,2,2366
3,1,4,0,0,0,2,2367
38,2,40,1,0,1,2,2368
131,231,362,13,36,49,2,2369
2,6,8,0,0,0,2,2370
4,2,6,0,0,0,2,2371
29,4,33,0,0,0,2,2372
19,2,21,0,0,0,2,2373
77,32,109,0,0,0,2,2374
41,11,52,1,0,1,2,2375
9,2,11,0,1,1,2,2376
10,3,13,0,0,0,2,2377
9,0,9,0,0,0,2,2378
7,7,14,0,0,0,2,2379
2,2,4,0,0,0,2,2380
15,6,21,0,0,0,2,2381
8,4,12,0,0,0,2,2382
40,96,136,0,2,2,2,2383
74,156,230,2,7,9,2,2384
0,0,0,-1,0,-1,2,2385
0,0,0,-1,-8,-9,2,2386
0,0,0,0,0,0,2,2387
0,0,0,-1,0,-1,2,2388
0,0,0,0,0,0,2,2389
16,12,28,1,0,1,2,2390
1,1,2,0,0,0,2,2391
0,0,0,-2,-3,-5,2,2392
2,0,2,0,0,0,2,2393
1,5,6,0,0,0,2,2394
1,1,2,0,0,0,2,2395
1,0,1,0,0,0,2,2396
4,3,7,0,2,2,2,2397
3,8,11,0,1,1,2,2398
4,6,10,0,0,0,2,2399
8,34,42,0,0,0,2,2400
9,1,10,0,0,0,2,2401
1,1,2,0,0,0,2,2402
2,2,4,0,0,0,2,2403
13,6,19,2,1,3,2,2404
44,59,103,0,0,0,2,2405
10,7,17,0,0,0,2,2406
10,11,21,0,0,0,2,2407
813,501,1314,16,15,31,2,2408
2,0,2,0,0,0,2,2409
0,3,3,0,0,0,2,2410
7,6,13,1,0,1,2,2411
0,0,0,0,0,0,2,2412
11,19,30,0,0,0,2,2413
23,23,46,4,2,6,2,2414
2,6,8,1,0,1,2,2415
2,3,5,0,0,0,2,2416
0,5,5,0,0,0,2,2417
0,14,14,0,1,1,2,2418
2,1,3,0,0,0,2,2419
0,0,0,0,0,0,2,2420
6,3,9,0,0,0,2,2421
3,6,9,0,0,0,2,2422
1,0,1,0,0,0,2,2423
1,0,1,0,0,0,2,2424
0,0,0,0,0,0,2,2425
0,4,4,0,0,0,2,2426
2,12,14,0,2,2,2,2427
0,0,0,0,0,0,2,2428
150,138,288,2,2,4,2,2429
3,2,5,0,0,0,2,2430
6,2,8,0,0,0,2,2431
23,4,27,2,0,2,2,2432
25,16,41,1,0,1,2,2433
3,1,4,0,0,0,2,2434
0,1,1,0,0,0,2,2435
2,2,4,0,0,0,2,2436
2,6,8,0,0,0,2,2437
2,6,8,0,0,0,2,2438
1,0,1,0,0,0,2,2439
1,0,1,0,0,0,2,2440
21,113,134,1,4,5,2,2441
0,1,1,0,0,0,2,2442
1,11,12,0,2,2,2,2443
4,5,9,2,1,3,2,2444
2,0,2,0,0,0,2,2445
95,39,134,3,2,5,2,2446
18,14,32,1,0,1,2,2447
16,21,37,0,0,0,2,2448
13,12,25,0,1,1,2,2449
26,10,36,2,0,2,2,2450
32,7,39,2,0,2,2,2451
0,0,0,0,0,0,2,2452
0,0,0,0,0,0,2,2453
15,0,15,1,0,1,2,2454
47,7,54,4,2,6,2,2455
20,11,31,1,1,2,2,2456
7718,6102,13820,832,544,1376,2,2457
8,1,9,1,0,1,2,2458
293,659,952,22,26,48,2,2459
40,8,48,1,0,1,2,2460
14,3,17,0,0,0,2,2461
9,3,12,0,1,1,2,2462
2,4,6,0,0,0,2,2463
2,2,4,0,1,1,2,2464
13,6,19,0,0,0,2,2465
33,16,49,3,3,6,2,2466
4,12,16,0,0,0,2,2467
13,5,18,0,0,0,2,2468
0,1,1,0,0,0,2,2469
0,2,2,0,0,0,2,2470
1,0,1,0,0,0,2,2471
2,2,4,0,0,0,2,2472
0,2,2,0,0,0,2,2473
1,1,2,0,0,0,2,2474
4,0,4,0,0,0,2,2475
11,15,26,0,1,1,2,2476
195,76,271,8,5,13,2,2477
5,4,9,0,0,0,2,2478
9,7,16,0,0,0,2,2479
8,4,12,0,0,0,2,2480
33,7,40,2,0,2,2,2481
23,10,33,0,0,0,2,2482
1,1,2,0,0,0,2,2483
0,1,1,0,0,0,2,2484
0,0,0,0,0,0,2,2485
0,0,0,0,0,0,2,2486
3,0,3,0,0,0,2,2487
1,2,3,0,0,0,2,2488
0,1,1,0,0,0,2,2489
0,0,0,0,0,0,2,2490
1,0,1,0,0,0,2,2491
0,1,1,0,1,1,2,2492
1,0,1,0,0,0,2,2493
1,1,2,0,0,0,2,2494
0,0,0,0,0,0,2,2495
17,5,22,0,0,0,2,2496
6,1,7,0,0,0,2,2497
30,10,40,1,1,2,2,2498
3,1,4,0,0,0,2,2499
4,4,8,0,0,0,2,2500
0,1,1,0,0,0,2,2501
6,9,15,1,0,1,2,2502
6962,9183,16145,90,102,192,2,2503
2,2,4,0,0,0,2,2504
0,1,1,0,0,0,2,2505
4,2,6,0,0,0,2,2506
1,0,1,0,0,0,2,2507
0,1,1,0,0,0,2,2508
2,2,4,0,0,0,2,2509
1,0,1,1,0,1,2,2510
5,2,7,1,0,1,2,2511
2,0,2,0,0,0,2,2512
3,1,4,0,0,0,2,2513
2,0,2,0,0,0,2,2514
3,0,3,0,0,0,2,2515
2,0,2,0,0,0,2,2516
97,39,136,8,0,8,2,2517
131,263,394,12,19,31,2,2518
40,15,55,0,0,0,2,2519
6,5,11,0,0,0,2,2520
1,0,1,0,0,0,2,2521
0,1,1,0,0,0,2,2522
5,3,8,1,0,1,2,2523
7,2,9,0,0,0,2,2524
3,0,3,1,0,1,2,2525
6,0,6,0,0,0,2,2526
20,57,77,1,5,6,2,2527
33,33,66,1,1,2,2,2528
6,2,8,0,0,0,2,2529
1,5,6,0,0,0,2,2530
8,11,19,0,0,0,2,2531
61,11,72,2,0,2,2,2532
3,8,11,0,2,2,2,2533
28,34,62,0,6,6,2,2534
12,8,20,1,1,2,2,2535
1,2,3,0,0,0,2,2536
1,0,1,0,0,0,2,2537
59,49,108,2,0,2,2,2538
2523,2282,4805,143,97,240,2,2539
365,191,556,8,10,18,2,2540
1,0,1,0,0,0,2,2541
4,2,6,0,0,0,2,2542
84,13,97,2,1,3,2,2543
96,45,141,12,4,16,2,2544
120,23,143,5,0,5,2,2545
30,30,60,0,2,2,2,2546
48,28,76,2,2,4,2,2547
1,5,6,1,0,1,2,2548
30,12,42,3,1,4,2,2549
24,11,35,1,0,1,2,2550
3,1,4,0,0,0,2,2551
16,15,31,2,0,2,2,2552
0,0,0,0,0,0,2,2553
0,3,3,0,0,0,2,2554
6,4,10,0,0,0,2,2555
2,2,4,1,0,1,2,2556
0,0,0,0,0,0,2,2557
405,507,912,113,160,273,2,2558
11,3,14,0,0,0,2,2559
27,7,34,2,1,3,2,2560
6,0,6,1,0,1,2,2561
1,0,1,0,0,0,2,2562
6,1,7,1,0,1,2,2563
12,2,14,1,0,1,2,2564
7,1,8,0,0,0,2,2565
0,0,0,0,0,0,2,2566
1,0,1,0,0,0,2,2567
7,13,20,0,0,0,2,2568
12,11,23,1,0,1,2,2569
23,12,35,2,1,3,2,2570
0,0,0,-265,-139,-404,2,2571
0,1,1,0,0,0,2,2572
46,18,64,1,0,1,2,2573
7,0,7,0,0,0,2,2574
4,1,5,0,0,0,2,2575
0,0,0,0,0,0,2,2576
1,6,7,0,0,0,2,2577
0,1,1,0,1,1,2,2578
1,0,1,0,0,0,2,2579
98,36,134,2,2,4,2,2580
22,4,26,0,0,0,2,2581
190,131,321,8,14,22,2,2582
45,3,48,1,0,1,2,2583
54,70,124,1,0,1,2,2584
1,0,1,0,0,0,2,2585
22,3,25,0,0,0,2,2586
5,2,7,0,0,0,2,2587
8,21,29,2,0,2,2,2588
10,7,17,1,2,3,2,2589
4,3,7,0,0,0,2,2590
3,2,5,0,1,1,2,2591
14,4,18,0,0,0,2,2592
8,6,14,0,0,0,2,2593
19,9,28,1,2,3,2,2594
54,21,75,9,2,11,2,2595
3,4,7,0,0,0,2,2596
7,15,22,0,0,0,2,2597
18,10,28,0,0,0,2,2598
23,10,33,0,0,0,2,2599
4,1,5,0,0,0,2,2600
1,7,8,0,1,1,2,2601
125,7,132,1,0,1,2,2602
0,0,0,-80,-189,-269,2,2603
185,109,294,2,1,3,2,2604
184,425,609,10,14,24,2,2605
5,3,8,0,0,0,2,2606
29,31,60,4,2,6,2,2607
107,27,134,1,0,1,2,2608
63,29,92,2,0,2,2,2609
4,4,8,0,0,0,2,2610
35,23,58,3,2,5,2,2611
1,0,1,0,0,0,2,2612
13,6,19,0,0,0,2,2613
48,221,269,1,15,16,2,2614
51,24,75,4,2,6,2,2615
41,10,51,0,0,0,2,2616
111,21,132,3,0,3,2,2617
35,4,39,0,0,0,2,2618
5,5,10,0,0,0,2,2619
183,772,955,7,9,16,2,2620
18,19,37,0,4,4,2,2621
24,32,56,0,1,1,2,2622
5049,1561,6610,247,76,323,2,2623
20,9,29,0,0,0,2,2624
7,0,7,1,0,1,2,2625
6,4,10,0,0,0,2,2626
6,0,6,1,0,1,2,2627
11,6,17,0,0,0,2,2628
17,18,35,0,0,0,2,2629
36,11,47,0,0,0,2,2630
10,0,10,0,0,0,2,2631
467,513,980,18,18,36,2,2632
1948,4483,6431,189,277,466,2,2633
469,259,728,17,12,29,2,2634
2,0,2,0,0,0,2,2635
2,1,3,0,0,0,2,2636
24,7,31,2,1,3,2,2637
21,9,30,1,0,1,2,2638
2,2,4,0,0,0,2,2639
5,3,8,0,2,2,2,2640
1142,1045,2187,34,25,59,2,2641
294,236,530,5,7,12,2,2642
1,3,4,0,0,0,2,2643
1,4,5,0,0,0,2,2644
18,8,26,2,0,2,2,2645
50,32,82,4,1,5,2,2646
1,0,1,0,0,0,2,2647
15,4,19,0,0,0,2,2648
4,0,4,0,0,0,2,2649
3,0,3,0,0,0,2,2650
4,3,7,0,0,0,2,2651
1,2,3,0,0,0,2,2652
88,81,169,3,1,4,2,2653
12,5,17,2,1,3,2,2654
4,5,9,0,0,0,2,2655
1,0,1,0,0,0,2,2656
5,4,9,0,0,0,2,2657
3,4,7,0,0,0,2,2658
0,0,0,-8,0,-8,2,2659
51,16,67,8,2,10,2,2660
8814,3906,12720,2,7,9,2,2661
0,0,0,-6,-6,-12,2,2662
37,52,89,0,1,1,2,2663
760,158,918,23,7,30,2,2664
25,4,29,6,0,6,2,2665
9,0,9,1,0,1,2,2666
7,5,12,1,2,3,2,2667
288,146,434,46,30,76,2,2668
3,0,3,0,0,0,2,2669
419,70,489,18,4,22,2,2670
9,0,9,0,0,0,2,2671
6,1,7,1,0,1,2,2672
8,7,15,0,1,1,2,2673
14,5,19,3,1,4,2,2674
9,1,10,0,0,0,2,2675
37,8,45,3,0,3,2,2676
35,6,41,4,0,4,2,2677
321,70,391,1,1,2,2,2678
109,403,512,2,16,18,2,2679
2379,4892,7271,115,135,250,2,2680
33,80,113,0,5,5,2,2681
3,5,8,0,0,0,2,2682
32,8,40,1,0,1,2,2683
71,54,125,1,1,2,2,2684
27,2,29,0,0,0,2,2685
51,24,75,0,0,0,2,2686
1,1,2,0,0,0,2,2687
2,2,4,0,1,1,2,2688
3,1,4,0,0,0,2,2689
8,6,14,0,0,0,2,2690
2,0,2,0,0,0,2,2691
2,3,5,0,0,0,2,2692
1,4,5,0,0,0,2,2693
0,1,1,0,0,0,2,2694
1,2,3,0,0,0,2,2695
5,4,9,0,0,0,2,2696
2,0,2,0,0,0,2,2697
0,1,1,0,0,0,2,2698
5,2,7,2,0,2,2,2699
3,2,5,1,0,1,2,2700
29,15,44,0,3,3,2,2701
3,1,4,0,0,0,2,2702
4,3,7,0,0,0,2,2703
126,195,321,10,12,22,2,2704
17182,16957,34139,48,62,110,2,2705
22,13,35,0,0,0,2,2706
33,21,54,0,0,0,2,2707
2617,2477,5094,38,33,71,2,2708
9,4,13,0,0,0,2,2709
7,5,12,0,1,1,2,2710
5,5,10,0,1,1,2,2711
4,5,9,0,0,0,2,2712
35,16,51,1,2,3,2,2713
50,29,79,1,2,3,2,2714
2,4,6,0,1,1,2,2715
1,0,1,0,0,0,2,2716
66,39,105,2,5,7,2,2717
2,1,3,0,0,0,2,2718
3,6,9,0,1,1,2,2719
3,0,3,0,0,0,2,2720
79,213,292,3,6,9,2,2721
42,32,74,2,1,3,2,2722
1414,4404,5818,27,51,78,2,2723
73,548,621,2,2,4,2,2724
52,20,72,0,0,0,2,2725
38,22,60,2,1,3,2,2726
20,6,26,3,0,3,2,2727
1,0,1,0,0,0,2,2728
344,357,701,17,12,29,2,2729
50,41,91,2,2,4,2,2730
24,5,29,0,0,0,2,2731
85,18,103,0,0,0,2,2732
83,27,110,3,0,3,2,2733
10,9,19,1,0,1,2,2734
4,3,7,0,0,0,2,2735
207,677,884,14,23,37,2,2736
28,25,53,1,4,5,2,2737
2,5,7,0,1,1,2,2738
4,1,5,0,0,0,2,2739
0,2,2,0,1,1,2,2740
0,1,1,0,0,0,2,2741
1,0,1,0,0,0,2,2742
61,18,79,2,1,3,2,2743
68,142,210,14,27,41,2,2744
263,802,1065,15,83,98,2,2745
0,0,0,-213,-601,-814,2,2746
525,164,689,0,0,0,2,2747
395,186,581,25,5,30,2,2748
40,77,117,3,7,10,2,2749
0,0,0,-41,-185,-226,2,2750
0,0,0,-20,-60,-80,2,2751
2,0,2,0,0,0,2,2752
0,0,0,-2,-1,-3,2,2753
2,4,6,0,0,0,2,2754
6,1,7,0,1,1,2,2755
2,0,2,1,0,1,2,2756
17,23,40,2,0,2,2,2757
13,47,60,2,3,5,2,2758
144,17,161,6,2,8,2,2759
8,7,15,0,0,0,2,2760
2,3,5,0,0,0,2,2761
2,1,3,0,0,0,2,2762
0,3,3,0,0,0,2,2763
0,0,0,0,0,0,2,2764
0,1,1,0,0,0,2,2765
2,2,4,0,0,0,2,2766
2,0,2,0,0,0,2,2767
1,1,2,0,0,0,2,2768
10,5,15,0,0,0,2,2769
5,5,10,1,0,1,2,2770
1,0,1,0,0,0,2,2771
0,0,0,0,0,0,2,2772
2,15,17,0,1,1,2,2773
0,0,0,-11,-32,-43,2,2774
2344,2309,4653,84,46,130,2,2775
8,4,12,1,0,1,2,2776
57,56,113,6,6,12,2,2777
20,19,39,2,2,4,2,2778
12,3,15,2,0,2,2,2779
35,46,81,3,4,7,2,2780
0,0,0,0,0,0,2,2781
5,10,15,0,1,1,2,2782
6,7,13,0,0,0,2,2783
29,58,87,5,13,18,2,2784
6,5,11,1,0,1,2,2785
27,21,48,0,0,0,2,2786
4,9,13,0,0,0,2,2787
8,8,16,0,0,0,2,2788
72,47,119,13,6,19,2,2789
0,0,0,0,0,0,2,2790
41,72,113,2,3,5,2,2791
2,3,5,0,0,0,2,2792
2,0,2,1,0,1,2,2793
2,1,3,0,0,0,2,2794
8,2,10,1,0,1,2,2795
2,9,11,0,0,0,2,2796
0,4,4,0,1,1,2,2797
2,5,7,1,0,1,2,2798
1,1,2,0,0,0,2,2799
0,2,2,0,0,0,2,2800
2,0,2,0,0,0,2,2801
3,8,11,2,0,2,2,2802
7,20,27,1,0,1,2,2803
1,1,2,0,0,0,2,2804
0,2,2,0,0,0,2,2805
0,0,0,0,0,0,2,2806
5,1,6,0,0,0,2,2807
6,5,11,0,0,0,2,2808
3,2,5,0,0,0,2,2809
1,1,2,0,0,0,2,2810
3,3,6,0,0,0,2,2811
12,5,17,1,0,1,2,2812
2,2,4,0,0,0,2,2813
14,2,16,1,0,1,2,2814
3,4,7,0,0,0,2,2815
4,0,4,0,0,0,2,2816
4,9,13,0,1,1,2,2817
0,4,4,0,1,1,2,2818
14,48,62,0,5,5,2,2819
2,2,4,0,0,0,2,2820
0,1,1,0,0,0,2,2821
3,3,6,0,0,0,2,2822
4,1,5,0,0,0,2,2823
4896,21552,26448,47,55,102,2,2824
2069,2409,4478,14,22,36,2,2825
3,2,5,0,0,0,2,2826
1,0,1,0,0,0,2,2827
32,1,33,0,0,0,2,2828
2,2,4,0,0,0,2,2829
0,0,0,0,0,0,2,2830
1,0,1,0,0,0,2,2831
0,1,1,0,0,0,2,2832
1,0,1,0,0,0,2,2833
0,3,3,0,0,0,2,2834
3,2,5,0,0,0,2,2835
5,3,8,0,0,0,2,2836
1,0,1,1,0,1,2,2837
0,0,0,0,0,0,2,2838
14,4,18,2,0,2,2,2839
10,7,17,1,0,1,2,2840
11,1,12,0,1,1,2,2841
15,9,24,0,1,1,2,2842
2,1,3,1,0,1,2,2843
5,0,5,1,0,1,2,2844
0,0,0,0,0,0,2,2845
7,3,10,0,0,0,2,2846
2,6,8,0,1,1,2,2847
16,50,66,3,2,5,2,2848
9,7,16,1,0,1,2,2849
24,89,113,2,21,23,2,2850
21,20,41,1,0,1,2,2851
0,1,1,0,0,0,2,2852
81,255,336,8,15,23,2,2853
25,33,58,2,2,4,2,2854
26,31,57,0,3,3,2,2855
38,106,144,3,8,11,2,2856
13,24,37,2,0,2,2,2857
19,17,36,0,3,3,2,2858
17,8,25,3,1,4,2,2859
18,40,58,3,4,7,2,2860
4,12,16,0,1,1,2,2861
8,3,11,1,0,1,2,2862
1,1,2,0,0,0,2,2863
0,0,0,0,0,0,2,2864
2,3,5,0,0,0,2,2865
0,0,0,0,0,0,2,2866
3,4,7,0,0,0,2,2867
0,1,1,0,1,1,2,2868
51,258,309,4,16,20,2,2869
1,0,1,0,0,0,2,2870
4,1,5,0,0,0,2,2871
47,37,84,1,3,4,2,2872
1,1,2,0,0,0,2,2873
5,10,15,1,0,1,2,2874
30,13,43,3,2,5,2,2875
2,2,4,0,0,0,2,2876
27,27,54,1,1,2,2,2877
17,7,24,5,1,6,2,2878
69,147,216,6,12,18,2,2879
9,50,59,0,0,0,2,2880
106,79,185,1,0,1,2,2881
44,102,146,1,0,1,2,2882
0,0,0,0,0,0,2,2883
28,17,45,1,0,1,2,2884
234,111,345,12,10,22,2,2885
12,28,40,3,1,4,2,2886
26,39,65,0,1,1,2,2887
81,32,113,8,5,13,2,2888
2111,790,2901,160,50,210,2,2889
33,95,128,8,6,14,2,2890
9,26,35,1,0,1,2,2891
25,81,106,0,1,1,2,2892
33,119,152,3,4,7,2,2893
191,718,909,12,32,44,2,2894
12,6,18,1,1,2,2,2895
0,0,0,0,0,0,2,2896
6,6,12,0,2,2,2,2897
6,14,20,0,0,0,2,2898
3,3,6,1,0,1,2,2899
120,215,335,16,26,42,2,2900
111,89,200,22,14,36,2,2901
10,14,24,1,0,1,2,2902
1,2,3,0,0,0,2,2903
0,3,3,0,1,1,2,2904
10,47,57,2,4,6,2,2905
0,0,0,0,0,0,2,2906
29,99,128,2,4,6,2,2907
4,4,8,0,0,0,2,2908
6,3,9,2,0,2,2,2909
10,52,62,3,5,8,2,2910
0,2,2,0,0,0,2,2911
33,146,179,1,1,2,2,2912
9,4,13,0,0,0,2,2913
6,1,7,1,0,1,2,2914
1,0,1,0,0,0,2,2915
2,0,2,0,0,0,2,2916
24,23,47,0,0,0,2,2917
6,2,8,0,0,0,2,2918
4,4,8,0,0,0,2,2919
2,2,4,0,0,0,2,2920
30,101,131,3,5,8,2,2921
4,3,7,0,0,0,2,2922
1,4,5,0,0,0,2,2923
1,0,1,0,0,0,2,2924
1,7,8,0,0,0,2,2925
16,23,39,2,1,3,2,2926
11,2,13,1,0,1,2,2927
1,6,7,0,0,0,2,2928
718,443,1161,53,26,79,2,2929
65,94,159,4,3,7,2,2930
0,3,3,0,0,0,2,2931
3,8,11,0,0,0,2,2932
164,195,359,9,15,24,2,2933
1,6,7,0,0,0,2,2934
3,0,3,0,0,0,2,2935
828,357,1185,9,6,15,2,2936
6,8,14,0,0,0,2,2937
1,6,7,0,0,0,2,2938
9,0,9,1,0,1,2,2939
37,8,45,2,0,2,2,2940
7,7,14,0,1,1,2,2941
1,1,2,0,0,0,2,2942
4,2,6,0,0,0,2,2943
2,3,5,0,1,1,2,2944
3,2,5,0,0,0,2,2945
193,23,216,28,3,31,2,2946
524,67,591,43,5,48,2,2947
20,2,22,1,0,1,2,2948
3,0,3,0,0,0,2,2949
0,0,0,0,0,0,2,2950
11,1,12,0,0,0,2,2951
132,226,358,20,18,38,2,2952
10,70,80,2,13,15,2,2953
21,10,31,3,0,3,2,2954
46,45,91,2,1,3,2,2955
15,9,24,3,1,4,2,2956
18,14,32,2,1,3,2,2957
0,0,0,0,0,0,2,2958
69,88,157,5,9,14,2,2959
202,245,447,11,11,22,2,2960
9,7,16,1,2,3,2,2961
16,16,32,3,0,3,2,2962
8,4,12,1,0,1,2,2963
9,3,12,0,2,2,2,2964
2,5,7,0,2,2,2,2965
0,1,1,0,0,0,2,2966
0,11,11,0,2,2,2,2967
4,2,6,0,0,0,2,2968
6508,16142,22650,289,775,1064,2,2969
0,0,0,0,0,0,2,2970
2,2,4,0,1,1,2,2971
0,1,1,0,0,0,2,2972
1,0,1,0,0,0,2,2973
2,3,5,1,0,1,2,2974
6,18,24,1,1,2,2,2975
8,10,18,1,0,1,2,2976
181,1239,1420,9,38,47,2,2977
2,5,7,0,1,1,2,2978
0,5,5,0,0,0,2,2979
0,1,1,0,0,0,2,2980
1,0,1,1,0,1,2,2981
0,1,1,0,0,0,2,2982
29,50,79,2,6,8,2,2983
12,7,19,0,1,1,2,2984
1,2,3,0,0,0,2,2985
1,11,12,1,3,4,2,2986
34,61,95,3,2,5,2,2987
53,191,244,4,17,21,2,2988
38,184,222,1,10,11,2,2989
0,2,2,0,1,1,2,2990
1,1,2,0,0,0,2,2991
0,2,2,0,0,0,2,2992
49,151,200,15,31,46,2,2993
2,0,2,2,0,2,2,2994
61,38,99,7,2,9,2,2995
0,0,0,0,0,0,2,2996
0,2,2,0,0,0,2,2997
0,1,1,0,0,0,2,2998
1,6,7,0,0,0,2,2999
3,25,28,2,1,3,2,3000
11,3,14,1,0,1,2,3001
80,30,110,3,3,6,2,3002
6,0,6,0,0,0,2,3003
6,4,10,0,1,1,2,3004
14,4,18,0,0,0,2,3005
1288,5289,6577,137,371,508,2,3006
0,0,0,0,0,0,2,3007
1,0,1,0,0,0,2,3008
0,0,0,0,0,0,2,3009
0,0,0,0,0,0,2,3010
1,0,1,0,0,0,2,3011
0,0,0,0,0,0,2,3012
0,0,0,0,0,0,2,3013
2,0,2,0,0,0,2,3014
6,15,21,0,0,0,2,3015
122,257,379,1,14,15,2,3016
3,2,5,0,0,0,2,3017
0,1,1,0,0,0,2,3018
2,5,7,0,0,0,2,3019
1,0,1,0,0,0,2,3020
2,11,13,1,0,1,2,3021
1,1,2,0,0,0,2,3022
13,9,22,0,1,1,2,3023
1,0,1,0,0,0,2,3024
19,21,40,7,6,13,2,3025
7,0,7,0,0,0,2,3026
8,19,27,0,2,2,2,3027
0,2,2,0,0,0,2,3028
2,3,5,0,0,0,2,3029
2,0,2,0,0,0,2,3030
0,2,2,0,0,0,2,3031
2,3,5,0,0,0,2,3032
5,14,19,0,1,1,2,3033
1,8,9,0,0,0,2,3034
1,3,4,0,0,0,2,3035
9,5,14,2,0,2,2,3036
106,43,149,10,11,21,2,3037
129,108,237,4,0,4,2,3038
22,9,31,0,0,0,2,3039
120,304,424,9,26,35,2,3040
95,158,253,3,12,15,2,3041
17,13,30,3,3,6,2,3042
5,11,16,0,1,1,2,3043
209,345,554,18,18,36,2,3044
2,22,24,0,0,0,2,3045
0,0,0,0,0,0,2,3046
0,2,2,0,0,0,2,3047
1,0,1,0,0,0,2,3048
46,60,106,4,1,5,2,3049
139,111,250,16,3,19,2,3050
1,5,6,0,0,0,2,3051
11,4,15,1,0,1,2,3052
0,0,0,0,0,0,2,3053
0,0,0,0,0,0,2,3054
1,0,1,0,0,0,2,3055
6,1,7,1,0,1,2,3056
0,2,2,0,0,0,2,3057
28,15,43,5,3,8,2,3058
1,1,2,0,0,0,2,3059
1,1,2,0,0,0,2,3060
18,9,27,2,1,3,2,3061
15,85,100,2,3,5,2,3062
32,1,33,0,0,0,2,3063
1,0,1,0,0,0,2,3064
16,0,16,0,0,0,2,3065
4,0,4,0,0,0,2,3066
5,0,5,0,0,0,2,3067
1,0,1,0,0,0,2,3068
2,1,3,0,0,0,2,3069
1,2,3,0,0,0,2,3070
44,120,164,13,28,41,2,3071
2,3,5,0,0,0,2,3072
96,131,227,4,12,16,2,3073
22,15,37,1,0,1,2,3074
0,2,2,0,0,0,2,3075
1,0,1,0,0,0,2,3076
1,9,10,0,0,0,2,3077
1,2,3,0,0,0,2,3078
80,68,148,3,1,4,2,3079
0,0,0,0,0,0,2,3080
1,6,7,0,1,1,2,3081
4,21,25,0,2,2,2,3082
10,14,24,2,1,3,2,3083
6,0,6,0,0,0,2,3084
13,11,24,0,1,1,2,3085
9,24,33,3,4,7,2,3086
1,3,4,0,0,0,2,3087
2,0,2,0,0,0,2,3088
1,1,2,0,0,0,2,3089
2,0,2,0,0,0,2,3090
0,1,1,0,0,0,2,3091
3,1,4,0,0,0,2,3092
38,67,105,4,0,4,2,3093
20,16,36,1,1,2,2,3094
110,84,194,11,10,21,2,3095
1,1,2,0,0,0,2,3096
0,0,0,0,0,0,2,3097
7,4,11,0,0,0,2,3098
1,0,1,0,0,0,2,3099
0,0,0,0,0,0,2,3100
1,0,1,0,0,0,2,3101
9,10,19,0,1,1,2,3102
0,6,6,0,0,0,2,3103
5,13,18,0,0,0,2,3104
2,2,4,0,0,0,2,3105
0,0,0,0,0,0,2,3106
0,0,0,0,0,0,2,3107
0,0,0,0,0,0,2,3108
0,0,0,0,0,0,2,3109
0,0,0,0,0,0,2,3110
0,0,0,0,0,0,2,3111
186,345,531,48,62,110,2,3112
7,13,20,0,1,1,2,3113
2,5,7,0,1,1,2,3114
1,2,3,0,2,2,2,3115
0,4,4,0,0,0,2,3116
1,0,1,0,0,0,2,3117
2,0,2,1,0,1,2,3118
8,4,12,1,0,1,2,3119
0,2,2,0,0,0,2,3120
11,48,59,2,2,4,2,3121
28495,47692,76187,1769,2273,4042,2,3122
51,183,234,1,8,9,2,3123
33083,50787,83870,2196,1667,3863,2,3124
437,2307,2744,34,114,148,2,3125
7554,17171,24725,294,398,692,2,3126
49,143,192,4,8,12,2,3127
93,480,573,8,27,35,2,3128
32,85,117,1,8,9,2,3129
10814,29853,40667,185,275,460,2,3130
24,106,130,1,2,3,2,3131
0,1,1,0,0,0,2,3132
0,0,0,0,0,0,2,3133
13,22,35,4,4,8,2,3134
20,33,53,3,12,15,2,3135
74,115,189,7,21,28,2,3136
37,51,88,7,9,16,2,3137
54,144,198,9,20,29,2,3138
14,59,73,2,18,20,2,3139
92,141,233,9,15,24,2,3140
79,173,252,12,25,37,2,3141
85,239,324,5,26,31,2,3142
51,175,226,5,26,31,2,3143
33,90,123,5,7,12,2,3144
94,162,256,10,17,27,2,3145
93,169,262,10,23,33,2,3146
400,690,1090,87,94,181,2,3147
2450,9070,11520,154,407,561,2,3148
11586,43632,55218,596,1971,2567,2,3149
1,3,4,0,0,0,2,3150
1,1,2,0,0,0,2,3151
3,2,5,0,0,0,2,3152
1,0,1,0,0,0,2,3153
0,1,1,0,0,0,2,3154
1,3,4,0,0,0,2,3155
2,5,7,0,0,0,2,3156
10,16,26,2,3,5,2,3157
0,0,0,0,0,0,2,3158
0,7,7,0,0,0,2,3159
0,2,2,0,0,0,2,3160
2,1,3,0,0,0,2,3161
0,0,0,0,0,0,2,3162
2,5,7,0,1,1,2,3163
0,0,0,0,0,0,2,3164
0,1,1,0,0,0,2,3165
4,4,8,1,0,1,2,3166
6,1,7,1,0,1,2,3167
1,0,1,1,0,1,2,3168
0,6,6,0,0,0,2,3169
5,0,5,0,0,0,2,3170
1,0,1,0,0,0,2,3171
0,0,0,0,0,0,2,3172
27,21,48,3,4,7,2,3173
14,3,17,2,2,4,2,3174
0,1,1,0,0,0,2,3175
4,0,4,0,0,0,2,3176
19,32,51,3,7,10,2,3177
2,1,3,0,0,0,2,3178
18,14,32,0,0,0,2,3179
26,23,49,2,7,9,2,3180
3,3,6,1,1,2,2,3181
73,337,410,14,41,55,2,3182
57,212,269,11,37,48,2,3183
306,178,484,34,20,54,2,3184
21,111,132,2,6,8,2,3185
4,21,25,2,3,5,2,3186
22,79,101,5,12,17,2,3187
0,1,1,0,0,0,2,3188
13,102,115,2,6,8,2,3189
2,10,12,0,0,0,2,3190
2,2,4,0,0,0,2,3191
1,2,3,0,0,0,2,3192
29,15,44,3,1,4,2,3193
18,17,35,2,1,3,2,3194
2,1,3,1,0,1,2,3195
2,0,2,0,0,0,2,3196
2,7,9,0,1,1,2,3197
0,0,0,0,0,0,2,3198
11,20,31,1,3,4,2,3199
0,0,0,0,0,0,2,3200
9,12,21,2,3,5,2,3201
0,1,1,0,0,0,2,3202
0,0,0,0,0,0,2,3203
24,27,51,8,6,14,2,3204
91,85,176,12,13,25,2,3205
76,70,146,11,15,26,2,3206
8,17,25,1,0,1,2,3207
89,149,238,18,39,57,2,3208
7,11,18,1,3,4,2,3209
121,289,410,25,54,79,2,3210
189,381,570,32,74,106,2,3211
102,130,232,4,9,13,2,3212
6,21,27,0,0,0,2,3213
40,116,156,8,8,16,2,3214
66,11,77,6,2,8,2,3215
2,0,2,0,0,0,2,3216
5,15,20,0,0,0,2,3217
0,0,0,0,0,0,2,3218
0,2,2,0,0,0,2,3219
0,0,0,0,0,0,2,3220
7,28,35,0,0,0,2,3221
1,1,2,0,1,1,2,3222
9,20,29,0,0,0,2,3223
1,1,2,0,0,0,2,3224
3,2,5,0,0,0,2,3225
8,14,22,0,0,0,2,3226
1,0,1,0,0,0,2,3227
0,0,0,0,0,0,2,3228
0,1,1,0,0,0,2,3229
0,1,1,0,0,0,2,3230
0,5,5,0,1,1,2,3231
160,454,614,15,39,54,2,3232
2,4,6,1,0,1,2,3233
2,2,4,0,0,0,2,3234
0,0,0,0,0,0,2,3235
3,12,15,0,0,0,2,3236
1,0,1,0,0,0,2,3237
1,2,3,0,0,0,2,3238
0,9,9,0,0,0,2,3239
15,30,45,0,0,0,2,3240
2,7,9,0,0,0,2,3241
12,16,28,2,0,2,2,3242
5,7,12,2,0,2,2,3243
0,0,0,0,0,0,2,3244
2,3,5,0,1,1,2,3245
0,0,0,0,0,0,2,3246
10,1,11,0,0,0,2,3247
3,3,6,0,0,0,2,3248
2,3,5,0,1,1,2,3249
4,0,4,0,0,0,2,3250
0,5,5,0,0,0,2,3251
1,1,2,0,0,0,2,3252
3,0,3,2,0,2,2,3253
0,0,0,0,0,0,2,3254
1,0,1,0,0,0,2,3255
11,6,17,1,0,1,2,3256
14,18,32,2,0,2,2,3257
1,0,1,0,0,0,2,3258
2,10,12,0,1,1,2,3259
1,1,2,0,0,0,2,3260
0,2,2,0,0,0,2,3261
0,0,0,0,0,0,2,3262
0,4,4,0,0,0,2,3263
55,240,295,0,7,7,2,3264
1,0,1,0,0,0,2,3265
6,18,24,1,0,1,2,3266
15,11,26,0,1,1,2,3267
1,7,8,1,0,1,2,3268
107,745,852,20,136,156,2,3269
118,501,619,6,34,40,2,3270
0,0,0,0,0,0,2,3271
13,48,61,3,5,8,2,3272
27,86,113,6,6,12,2,3273
0,5,5,0,0,0,2,3274
163,231,394,12,14,26,2,3275
8,6,14,0,0,0,2,3276
8,76,84,1,3,4,2,3277
3,10,13,1,1,2,2,3278
0,0,0,0,0,0,2,3279
1,2,3,0,0,0,2,3280
2,0,2,0,0,0,2,3281
1,0,1,0,0,0,2,3282
1,0,1,0,0,0,2,3283
0,0,0,0,0,0,2,3284
2,3,5,0,0,0,2,3285
66,146,212,2,6,8,2,3286
0,0,0,0,0,0,2,3287
0,0,0,0,0,0,2,3288
2,5,7,0,0,0,2,3289
0,2,2,0,1,1,2,3290
2,0,2,1,0,1,2,3291
1,4,5,0,0,0,2,3292
0,0,0,0,0,0,2,3293
2,3,5,1,0,1,2,3294
0,0,0,0,0,0,2,3295
0,0,0,0,0,0,2,3296
6,23,29,0,0,0,2,3297
3,0,3,0,0,0,2,3298
0,1,1,0,0,0,2,3299
1,5,6,0,1,1,2,3300
2,3,5,0,1,1,2,3301
3,5,8,0,0,0,2,3302
5,7,12,2,0,2,2,3303
0,0,0,0,0,0,2,3304
2,1,3,0,1,1,2,3305
4,6,10,0,0,0,2,3306
1,6,7,0,1,1,2,3307
0,3,3,0,0,0,2,3308
1,0,1,0,0,0,2,3309
1,2,3,0,0,0,2,3310
0,0,0,0,0,0,2,3311
2,0,2,2,0,2,2,3312
28,128,156,1,13,14,2,3313
668,1028,1696,90,110,200,2,3314
27,153,180,3,15,18,2,3315
2,4,6,0,1,1,2,3316
5,7,12,0,1,1,2,3317
90,666,756,10,27,37,2,3318
0,8,8,0,1,1,2,3319
0,0,0,0,0,0,2,3320
0,2,2,0,0,0,2,3321
0,3,3,0,0,0,2,3322
3,13,16,0,0,0,2,3323
25,140,165,0,5,5,2,3324
0,11,11,0,1,1,2,3325
54,133,187,1,6,7,2,3326
87,385,472,4,23,27,2,3327
2928,16583,19511,138,407,545,2,3328
2591,11362,13953,161,591,752,2,3329
236,795,1031,34,74,108,2,3330
72,314,386,8,15,23,2,3331
20,50,70,4,3,7,2,3332
0,0,0,0,0,0,2,3333
3,10,13,0,1,1,2,3334
317,682,999,34,38,72,2,3335
174,934,1108,19,64,83,2,3336
12,66,78,1,5,6,2,3337
229,727,956,9,28,37,2,3338
5350,14007,19357,301,592,893,2,3339
181,512,693,12,33,45,2,3340
142,434,576,12,36,48,2,3341
858,3323,4181,62,142,204,2,3342
1838,5994,7832,113,170,283,2,3343
3119,18412,21531,204,815,1019,2,3344
26,256,282,1,13,14,2,3345
80,183,263,8,16,24,2,3346
0,0,0,0,0,0,2,3347
190,443,633,15,33,48,2,3348
86,162,248,6,14,20,2,3349
60,67,127,6,3,9,2,3350
39,214,253,6,37,43,2,3351
0,0,0,0,0,0,2,3352
5,0,5,1,0,1,2,3353
1,1,2,0,0,0,2,3354
2,0,2,0,0,0,2,3355
0,0,0,0,0,0,2,3356
5,1,6,1,0,1,2,3357
1,0,1,1,0,1,2,3358
1,1,2,0,0,0,2,3359
1,1,2,0,0,0,2,3360
0,0,0,0,0,0,2,3361
27,66,93,4,3,7,2,3362
10,10,20,2,1,3,2,3363
0,0,0,0,0,0,2,3364
431,232,663,15,5,20,2,3365
1,1,2,0,0,0,2,3366
3,1,4,0,1,1,2,3367
9,21,30,0,3,3,2,3368
0,1,1,0,1,1,2,3369
0,0,0,0,0,0,2,3370
0,2,2,0,0,0,2,3371
0,0,0,0,0,0,2,3372
2,1,3,0,0,0,2,3373
1,2,3,0,0,0,2,3374
1,3,4,0,0,0,2,3375
1,6,7,0,2,2,2,3376
0,2,2,0,1,1,2,3377
2,2,4,0,0,0,2,3378
0,0,0,0,0,0,2,3379
0,1,1,0,1,1,2,3380
0,0,0,0,0,0,2,3381
4,0,4,0,0,0,2,3382
0,1,1,0,0,0,2,3383
2,9,11,0,0,0,2,3384
8,34,42,1,2,3,2,3385
0,2,2,0,0,0,2,3386
1,18,19,0,1,1,2,3387
0,0,0,0,0,0,2,3388
1,18,19,0,2,2,2,3389
6,2,8,0,0,0,2,3390
5,2,7,1,0,1,2,3391
11,4,15,1,0,1,2,3392
20,4,24,2,0,2,2,3393
15,21,36,3,3,6,2,3394
6,3,9,1,1,2,2,3395
62,33,95,6,6,12,2,3396
0,0,0,0,0,0,2,3397
38,40,78,4,4,8,2,3398
0,1,1,0,0,0,2,3399
0,2,2,0,0,0,2,3400
5,2,7,1,0,1,2,3401
3,1,4,0,0,0,2,3402
2,0,2,0,0,0,2,3403
0,0,0,0,0,0,2,3404
0,4,4,0,1,1,2,3405
3,0,3,0,0,0,2,3406
23,105,128,3,8,11,2,3407
16,55,71,0,4,4,2,3408
30,84,114,1,8,9,2,3409
2,2,4,0,0,0,2,3410
4,16,20,0,2,2,2,3411
13,80,93,2,11,13,2,3412
21,51,72,2,3,5,2,3413
3,10,13,0,0,0,2,3414
23,41,64,3,2,5,2,3415
4,10,14,2,0,2,2,3416
27,95,122,0,5,5,2,3417
497,1816,2313,77,136,213,2,3418
15,28,43,1,1,2,2,3419
0,6,6,0,1,1,2,3420
14,39,53,0,2,2,2,3421
163,353,516,1,10,11,2,3422
11,12,23,0,1,1,2,3423
3,4,7,0,1,1,2,3424
7,8,15,0,1,1,2,3425
8,11,19,2,3,5,2,3426
56,103,159,0,3,3,2,3427
86,171,257,11,15,26,2,3428
50,105,155,2,4,6,2,3429
166,165,331,16,16,32,2,3430
1104,764,1868,107,27,134,2,3431
12,23,35,0,0,0,2,3432
8,10,18,1,2,3,2,3433
2,3,5,0,0,0,2,3434
3,8,11,0,1,1,2,3435
21,48,69,2,2,4,2,3436
89,31,120,9,3,12,2,3437
80,294,374,8,11,19,2,3438
0,0,0,0,0,0,2,3439
5,3,8,0,1,1,2,3440
2,2,4,0,1,1,2,3441
12,6,18,2,0,2,2,3442
3,2,5,0,0,0,2,3443
2843,909,3752,151,58,209,2,3444
119,171,290,10,16,26,2,3445
49,58,107,4,6,10,2,3446
45,158,203,1,7,8,2,3447
934,2627,3561,70,169,239,2,3448
432,1381,1813,35,70,105,2,3449
6,45,51,0,2,2,2,3450
8,70,78,0,3,3,2,3451
2,19,21,0,0,0,2,3452
17,79,96,0,21,21,2,3453
1,0,1,1,0,1,2,3454
14,0,14,0,0,0,2,3455
1,1,2,0,0,0,2,3456
4,14,18,2,2,4,2,3457
2,6,8,0,2,2,2,3458
8418,40803,49221,497,2378,2875,2,3459
2,0,2,0,0,0,2,3460
2,1,3,0,0,0,2,3461
34,19,53,1,1,2,2,3462
16,9,25,1,0,1,2,3463
12,19,31,3,2,5,2,3464
93,126,219,2,2,4,2,3465
3,69,72,1,1,2,2,3466
1,0,1,1,0,1,2,3467
574,751,1325,29,46,75,2,3468
71,120,191,4,12,16,2,3469
2,0,2,0,0,0,2,3470
16,12,28,2,0,2,2,3471
2,1,3,0,0,0,2,3472
0,2,2,0,0,0,2,3473
0,9,9,0,0,0,2,3474
2,9,11,0,0,0,2,3475
0,6,6,0,1,1,2,3476
0,1,1,0,0,0,2,3477
3,1,4,1,0,1,2,3478
48,79,127,2,6,8,2,3479
283,959,1242,44,90,134,2,3480
31,50,81,2,5,7,2,3481
16,14,30,3,2,5,2,3482
3,12,15,0,2,2,2,3483
4,13,17,1,0,1,2,3484
32,95,127,5,17,22,2,3485
3,11,14,1,1,2,2,3486
4,4,8,1,0,1,2,3487
5,31,36,0,1,1,2,3488
2,2,4,0,0,0,2,3489
1,0,1,0,0,0,2,3490
1,6,7,0,0,0,2,3491
35,29,64,3,3,6,2,3492
5,4,9,1,0,1,2,3493
16,24,40,4,1,5,2,3494
5,24,29,1,5,6,2,3495
1,8,9,0,2,2,2,3496
1,7,8,0,0,0,2,3497
15,69,84,2,4,6,2,3498
5,12,17,0,0,0,2,3499
9,33,42,2,3,5,2,3500
1,1,2,0,0,0,2,3501
4,10,14,1,1,2,2,3502
0,1,1,0,1,1,2,3503
0,0,0,0,0,0,2,3504
365,885,1250,48,108,156,2,3505
110,246,356,6,10,16,2,3506
45,112,157,6,4,10,2,3507
7,30,37,1,1,2,2,3508
0,0,0,0,0,0,2,3509
0,0,0,0,0,0,2,3510
0,0,0,0,0,0,2,3511
63,46,109,10,2,12,2,3512
828,1843,2671,64,127,191,2,3513
76,200,276,13,19,32,2,3514
96,321,417,10,36,46,2,3515
230,1007,1237,15,83,98,2,3516
6,4,10,0,0,0,2,3517
13,19,32,1,1,2,2,3518
0,0,0,0,0,0,2,3519
138,284,422,9,20,29,2,3520
0,0,0,0,0,0,2,3521
0,0,0,0,0,0,2,3522
1,0,1,0,0,0,2,3523
1,0,1,0,0,0,2,3524
2,1,3,0,0,0,2,3525
3,9,12,2,2,4,2,3526
2,2,4,0,0,0,2,3527
0,0,0,0,0,0,2,3528
1,0,1,0,0,0,2,3529
0,3,3,0,0,0,2,3530
0,0,0,0,0,0,2,3531
0,0,0,0,0,0,2,3532
0,0,0,0,0,0,2,3533
6,6,12,0,0,0,2,3534
0,2,2,0,0,0,2,3535
1,5,6,0,0,0,2,3536
1,2,3,0,0,0,2,3537
6,9,15,1,0,1,2,3538
12,41,53,5,13,18,2,3539
89,130,219,9,9,18,2,3540
1,4,5,0,0,0,2,3541
5,8,13,0,0,0,2,3542
13,29,42,4,3,7,2,3543
1,0,1,0,0,0,2,3544
0,0,0,0,0,0,2,3545
958,1749,2707,99,176,275,2,3546
39,165,204,6,14,20,2,3547
14,104,118,0,6,6,2,3548
1,0,1,1,0,1,2,3549
5,0,5,0,0,0,2,3550
18,24,42,1,1,2,2,3551
6,0,6,1,0,1,2,3552
2,1,3,0,0,0,2,3553
1,3,4,1,0,1,2,3554
0,2,2,0,0,0,2,3555
108,111,219,4,6,10,2,3556
1,3,4,0,0,0,2,3557
12,34,46,3,6,9,2,3558
2,9,11,0,1,1,2,3559
5,0,5,0,0,0,2,3560
5,1,6,2,0,2,2,3561
8,28,36,0,1,1,2,3562
9,58,67,1,8,9,2,3563
0,0,0,0,0,0,2,3564
24,68,92,6,16,22,2,3565
2,1,3,0,0,0,2,3566
7,46,53,1,9,10,2,3567
86,406,492,17,56,73,2,3568
11,24,35,1,2,3,2,3569
1,2,3,0,0,0,2,3570
1,3,4,0,0,0,2,3571
2,1,3,0,0,0,2,3572
5,5,10,1,0,1,2,3573
9,10,19,4,2,6,2,3574
0,0,0,0,0,0,2,3575
0,1,1,0,0,0,2,3576
4,2,6,1,0,1,2,3577
7,30,37,0,0,0,2,3578
213,675,888,9,19,28,2,3579
41,104,145,2,5,7,2,3580
184,273,457,5,6,11,2,3581
4685,16421,21106,81,185,266,2,3582
1431,5141,6572,57,171,228,2,3583
52,199,251,3,11,14,2,3584
36,103,139,5,11,16,2,3585
2263,7344,9607,134,343,477,2,3586
2076,7371,9447,44,126,170,2,3587
1662,7268,8930,37,160,197,2,3588
4,3,7,0,0,0,2,3589
3,0,3,0,0,0,2,3590
1,1,2,0,0,0,2,3591
0,0,0,0,0,0,2,3592
5,33,38,0,4,4,2,3593
2,1,3,0,0,0,2,3594
0,2,2,0,0,0,2,3595
1,0,1,0,0,0,2,3596
3,2,5,1,0,1,2,3597
1,1,2,1,0,1,2,3598
0,0,0,0,0,0,2,3599
1,2,3,0,0,0,2,3600
26,37,63,3,1,4,2,3601
0,0,0,0,0,0,2,3602
38,103,141,8,19,27,2,3603
32,62,94,4,16,20,2,3604
1807,15824,17631,45,182,227,2,3605
16250,46923,63173,876,1538,2414,2,3606
59,190,249,2,2,4,2,3607
95,394,489,6,11,17,2,3608
23,136,159,2,4,6,2,3609
253,1087,1340,14,40,54,2,3610
795,2193,2988,210,469,679,2,3611
358,961,1319,19,31,50,2,3612
20,60,80,2,2,4,2,3613
29,108,137,3,6,9,2,3614
983,3798,4781,128,320,448,2,3615
5,1,6,1,0,1,2,3616
3,3,6,0,0,0,2,3617
263,108,371,27,7,34,2,3618
55,35,90,5,4,9,2,3619
2,15,17,0,2,2,2,3620
0,18,18,0,1,1,2,3621
3,8,11,0,1,1,2,3622
2,9,11,0,0,0,2,3623
425,705,1130,31,27,58,2,3624
395,1097,1492,20,53,73,2,3625
0,10,10,0,0,0,2,3626
74,28,102,6,3,9,2,3627
40,49,89,3,7,10,2,3628
210,58,268,13,4,17,2,3629
0,0,0,0,0,0,2,3630
63,16,79,3,0,3,2,3631
13,0,13,1,0,1,2,3632
2,1,3,0,0,0,2,3633
5,7,12,0,0,0,2,3634
7,21,28,2,0,2,2,3635
0,3,3,0,0,0,2,3636
1,0,1,0,0,0,2,3637
0,0,0,0,0,0,2,3638
0,2,2,0,0,0,2,3639
1,3,4,0,0,0,2,3640
0,2,2,0,0,0,2,3641
0,2,2,0,0,0,2,3642
5,3,8,0,0,0,2,3643
0,0,0,0,0,0,2,3644
4,1,5,0,0,0,2,3645
1,0,1,0,0,0,2,3646
1,1,2,0,0,0,2,3647
2,6,8,0,0,0,2,3648
0,0,0,0,0,0,2,3649
1,6,7,0,0,0,2,3650
0,1,1,0,0,0,2,3651
2,6,8,0,0,0,2,3652
6,21,27,0,0,0,2,3653
3,1,4,0,0,0,2,3654
0,0,0,0,0,0,2,3655
0,2,2,0,0,0,2,3656
2,5,7,0,0,0,2,3657
0,0,0,0,0,0,2,3658
9,13,22,0,1,1,2,3659
22,52,74,1,2,3,2,3660
28,67,95,2,4,6,2,3661
22,31,53,4,0,4,2,3662
55,121,176,2,1,3,2,3663
1,8,9,0,0,0,2,3664
2,27,29,0,1,1,2,3665
8,27,35,2,2,4,2,3666
0,0,0,0,0,0,2,3667
0,0,0,0,0,0,2,3668
1,1,2,0,0,0,2,3669
63,138,201,1,1,2,2,3670
466,2035,2501,14,30,44,2,3671
27,22,49,3,3,6,2,3672
9,9,18,1,2,3,2,3673
3,0,3,1,0,1,2,3674
43,175,218,4,13,17,2,3675
10,13,23,1,0,1,2,3676
13,60,73,1,4,5,2,3677
10,29,39,0,2,2,2,3678
3,4,7,2,0,2,2,3679
0,0,0,0,0,0,2,3680
3,17,20,0,0,0,2,3681
0,1,1,0,0,0,2,3682
0,0,0,0,0,0,2,3683
1,1,2,0,0,0,2,3684
0,0,0,0,0,0,2,3685
0,0,0,0,0,0,2,3686
483,1611,2094,25,68,93,2,3687
885,2860,3745,35,64,99,2,3688
111,209,320,3,7,10,2,3689
160,361,521,10,19,29,2,3690
186,218,404,23,21,44,2,3691
460,2499,2959,28,139,167,2,3692
6,13,19,2,1,3,2,3693
2,12,14,0,1,1,2,3694
1,1,2,0,0,0,2,3695
1,0,1,0,0,0,2,3696
0,0,0,0,0,0,2,3697
1,0,1,0,0,0,2,3698
0,0,0,0,0,0,2,3699
0,0,0,0,0,0,2,3700
4,7,11,0,0,0,2,3701
2,3,5,0,0,0,2,3702
16,11,27,1,0,1,2,3703
88,177,265,11,30,41,2,3704
4,2,6,0,0,0,2,3705
4,6,10,0,1,1,2,3706
27,17,44,3,0,3,2,3707
123,208,331,38,44,82,2,3708
0,1,1,0,0,0,2,3709
402,1527,1929,24,33,57,2,3710
11,7,18,2,0,2,2,3711
7,3,10,0,0,0,2,3712
145,405,550,18,27,45,2,3713
5,27,32,1,0,1,2,3714
0,0,0,-130,-363,-493,2,3715
17,11,28,1,6,7,2,3716
8,3,11,1,1,2,2,3717
0,0,0,0,0,0,2,3718
403,1387,1790,42,116,158,2,3719
31,122,153,2,7,9,2,3720
36,173,209,6,7,13,2,3721
7,35,42,1,1,2,2,3722
22,83,105,1,6,7,2,3723
0,1,1,0,0,0,2,3724
1,0,1,0,0,0,2,3725
0,0,0,0,0,0,2,3726
49,26,75,6,1,7,2,3727
35,55,90,2,7,9,2,3728
138,1357,1495,8,34,42,2,3729
7,13,20,1,2,3,2,3730
4,1,5,0,0,0,2,3731
17,19,36,2,1,3,2,3732
13,14,27,2,2,4,2,3733
2,19,21,0,0,0,2,3734
0,3,3,0,0,0,2,3735
0,1,1,0,0,0,2,3736
3,7,10,0,0,0,2,3737
0,1,1,0,0,0,2,3738
1,0,1,0,0,0,2,3739
0,0,0,0,0,0,2,3740
2,12,14,0,3,3,2,3741
0,0,0,0,0,0,2,3742
1,0,1,0,0,0,2,3743
1,0,1,0,0,0,2,3744
183,452,635,23,41,64,2,3745
217,682,899,23,69,92,2,3746
6,5,11,0,0,0,2,3747
503,1714,2217,54,134,188,2,3748
1,0,1,0,0,0,2,3749
1,5,6,0,0,0,2,3750
3,10,13,0,0,0,2,3751
16,4,20,7,1,8,2,3752
0,11,11,0,1,1,2,3753
1,2,3,1,0,1,2,3754
0,3,3,0,0,0,2,3755
0,0,0,0,0,0,2,3756
0,0,0,0,0,0,2,3757
0,0,0,0,0,0,2,3758
0,1,1,0,0,0,2,3759
0,0,0,0,0,0,2,3760
7,14,21,0,2,2,2,3761
0,0,0,0,0,0,2,3762
0,4,4,0,1,1,2,3763
16,45,61,1,1,2,2,3764
9,2,11,2,0,2,2,3765
1,0,1,0,0,0,2,3766
0,2,2,0,1,1,2,3767
2,0,2,0,0,0,2,3768
5,16,21,0,1,1,2,3769
0,0,0,0,0,0,2,3770
0,1,1,0,0,0,2,3771
0,0,0,0,0,0,2,3772
0,0,0,0,0,0,2,3773
42,49,91,13,3,16,2,3774
26,14,40,2,0,2,2,3775
1,0,1,1,0,1,2,3776
0,0,0,0,0,0,2,3777
0,0,0,0,0,0,2,3778
0,0,0,0,0,0,2,3779
24,18,42,2,1,3,2,3780
0,0,0,0,0,0,2,3781
2,0,2,0,0,0,2,3782
6,4,10,1,0,1,2,3783
468,164,632,37,12,49,2,3784
0,0,0,0,0,0,2,3785
0,1,1,0,0,0,2,3786
72,25,97,3,7,10,2,3787
16,9,25,2,0,2,2,3788
5,3,8,0,0,0,2,3789
1,1,2,0,0,0,2,3790
0,0,0,0,0,0,2,3791
0,0,0,0,0,0,2,3792
0,0,0,0,0,0,2,3793
7,2,9,2,0,2,2,3794
0,0,0,0,0,0,2,3795
1,0,1,0,0,0,2,3796
1,0,1,0,0,0,2,3797
0,0,0,0,0,0,2,3798
1,3,4,0,0,0,2,3799
2,0,2,1,0,1,2,3800
1,0,1,0,0,0,2,3801
0,0,0,0,0,0,2,3802
0,0,0,0,0,0,2,3803
1,0,1,1,0,1,2,3804
1,0,1,0,0,0,2,3805
1,0,1,0,0,0,2,3806
3,24,27,0,2,2,2,3807
0,0,0,0,0,0,2,3808
1,4,5,0,0,0,2,3809
0,2,2,0,0,0,2,3810
3,2,5,0,0,0,2,3811
0,0,0,0,0,0,2,3812
0,1,1,0,1,1,2,3813
0,1,1,0,1,1,2,3814
1,10,11,0,0,0,2,3815
0,0,0,0,0,0,2,3816
0,0,0,0,0,0,2,3817
0,0,0,0,0,0,2,3818
0,0,0,0,0,0,2,3819
0,0,0,0,0,0,2,3820
0,0,0,0,0,0,2,3821
0,0,0,0,0,0,2,3822
0,0,0,0,0,0,2,3823
0,0,0,0,0,0,2,3824
0,2,2,0,0,0,2,3825
0,1,1,0,0,0,2,3826
0,3,3,0,0,0,2,3827
31,137,168,6,27,33,2,3828
41,70,111,3,7,10,2,3829
7,11,18,0,1,1,2,3830
9,9,18,3,0,3,2,3831
10,28,38,3,0,3,2,3832
0,4,4,0,1,1,2,3833
10,10,20,1,5,6,2,3834
0,0,0,0,0,0,2,3835
126,336,462,19,37,56,2,3836
3,7,10,1,2,3,2,3837
4,5,9,0,0,0,2,3838
0,0,0,0,0,0,2,3839
0,5,5,0,0,0,2,3840
2,1,3,0,0,0,2,3841
811,3907,4718,52,222,274,2,3842
41,87,128,3,2,5,2,3843
2,1,3,0,0,0,2,3844
0,0,0,0,0,0,2,3845
0,0,0,0,0,0,2,3846
1,0,1,1,0,1,2,3847
2,5,7,0,2,2,2,3848
0,0,0,0,0,0,2,3849
0,0,0,0,0,0,2,3850
1,0,1,0,0,0,2,3851
0,0,0,0,0,0,2,3852
1,0,1,0,0,0,2,3853
0,0,0,0,0,0,2,3854
4,13,17,1,1,2,2,3855
2,0,2,0,0,0,2,3856
0,1,1,0,0,0,2,3857
2,0,2,1,0,1,2,3858
0,0,0,0,0,0,2,3859
14,9,23,1,1,2,2,3860
0,3,3,0,1,1,2,3861
2,4,6,1,0,1,2,3862
5,6,11,2,4,6,2,3863
11,2,13,1,1,2,2,3864
1,0,1,1,0,1,2,3865
80,37,117,2,1,3,2,3866
44,120,164,2,5,7,2,3867
2,5,7,0,0,0,2,3868
0,2,2,0,0,0,2,3869
3,2,5,0,0,0,2,3870
0,0,0,0,0,0,2,3871
1,1,2,0,0,0,2,3872
0,6,6,0,0,0,2,3873
7,2,9,3,0,3,2,3874
8,9,17,2,3,5,2,3875
2,3,5,0,1,1,2,3876
2,1,3,1,0,1,2,3877
0,1,1,0,0,0,2,3878
0,0,0,0,0,0,2,3879
3,5,8,0,0,0,2,3880
1,6,7,0,0,0,2,3881
1,1,2,1,0,1,2,3882
0,1,1,0,0,0,2,3883
2,1,3,1,0,1,2,3884
0,0,0,0,0,0,2,3885
0,4,4,0,0,0,2,3886
1,1,2,0,0,0,2,3887
36,18,54,8,3,11,2,3888
2,1,3,0,0,0,2,3889
10,8,18,1,1,2,2,3890
3,9,12,0,0,0,2,3891
0,0,0,0,0,0,2,3892
1,1,2,0,0,0,2,3893
1,2,3,0,0,0,2,3894
0,0,0,0,0,0,2,3895
3,19,22,0,2,2,2,3896
0,0,0,0,0,0,2,3897
3,7,10,0,0,0,2,3898
1,3,4,0,0,0,2,3899
2,1,3,0,0,0,2,3900
6,1,7,1,0,1,2,3901
6,1,7,0,0,0,2,3902
13,42,55,2,3,5,2,3903
2,12,14,0,0,0,2,3904
0,0,0,0,0,0,2,3905
0,2,2,0,0,0,2,3906
0,0,0,0,0,0,2,3907
0,0,0,0,0,0,2,3908
0,0,0,0,0,0,2,3909
4,4,8,0,0,0,2,3910
0,2,2,0,0,0,2,3911
8,5,13,2,1,3,2,3912
5,1,6,0,0,0,2,3913
2,2,4,0,0,0,2,3914
3,3,6,0,2,2,2,3915
2,0,2,0,0,0,2,3916
1,0,1,1,0,1,2,3917
0,0,0,0,0,0,2,3918
0,0,0,0,0,0,2,3919
0,0,0,0,0,0,2,3920
0,0,0,-10,-52,-62,2,3921
12,18,30,3,4,7,2,3922
0,0,0,0,0,0,2,3923
2,0,2,1,0,1,2,3924
0,0,0,0,0,0,2,3925
0,0,0,0,0,0,2,3926
16,11,27,2,2,4,2,3927
10,9,19,4,3,7,2,3928
1,3,4,0,0,0,2,3929
0,0,0,0,0,0,2,3930
0,0,0,0,0,0,2,3931
1,1,2,0,0,0,2,3932
118,332,450,15,49,64,2,3933
2,3,5,1,0,1,2,3934
0,0,0,-1,0,-1,2,3935
1,2,3,0,0,0,2,3936
0,1,1,0,0,0,2,3937
0,0,0,0,0,0,2,3938
0,0,0,-1,0,-1,2,3939
0,0,0,-1,0,-1,2,3940
1,0,1,0,0,0,2,3941
12,28,40,1,2,3,2,3942
0,0,0,0,0,0,2,3943
1,0,1,1,0,1,2,3944
4,0,4,0,0,0,2,3945
7,5,12,6,1,7,2,3946
0,0,0,0,0,0,2,3947
1,0,1,0,0,0,2,3948
1,1,2,1,0,1,2,3949
4,0,4,1,0,1,2,3950
69,196,265,15,29,44,2,3951
0,0,0,0,0,0,2,3952
1,1,2,0,0,0,2,3953
1,0,1,0,0,0,2,3954
2,2,4,1,1,2,2,3955
4,7,11,3,2,5,2,3956
0,0,0,0,0,0,2,3957
0,0,0,0,0,0,2,3958
8,32,40,0,1,1,2,3959
4,5,9,1,0,1,2,3960
1,0,1,0,0,0,2,3961
6,3,9,0,0,0,2,3962
0,0,0,0,0,0,2,3963
0,0,0,0,0,0,2,3964
6,4,10,0,0,0,2,3965
0,0,0,0,0,0,2,3966
0,0,0,0,0,0,2,3967
1,2,3,0,0,0,2,3968
7,1,8,3,1,4,2,3969
13,7,20,0,0,0,2,3970
10,3,13,2,1,3,2,3971
1,0,1,0,0,0,2,3972
0,0,0,0,0,0,2,3973
1,0,1,0,0,0,2,3974
2,0,2,0,0,0,2,3975
2,1,3,0,1,1,2,3976
2,2,4,0,1,1,2,3977
9,3,12,1,1,2,2,3978
0,0,0,0,0,0,2,3979
0,0,0,0,0,0,2,3980
0,0,0,0,0,0,2,3981
1,3,4,0,1,1,2,3982
0,0,0,0,0,0,2,3983
0,1,1,0,0,0,2,3984
1,2,3,0,1,1,2,3985
0,0,0,0,0,0,2,3986
0,0,0,0,0,0,2,3987
0,0,0,0,0,0,2,3988
6,62,68,0,5,5,2,3989
4,1,5,1,0,1,2,3990
0,0,0,0,0,0,2,3991
3,1,4,0,1,1,2,3992
0,0,0,0,0,0,2,3993
0,0,0,0,0,0,2,3994
6,0,6,0,0,0,2,3995
12,68,80,0,2,2,2,3996
2,23,25,0,0,0,2,3997
0,2,2,0,0,0,2,3998
0,0,0,0,0,0,2,3999
3,0,3,0,0,0,2,4000
2,1,3,0,1,1,2,4001
2,7,9,0,1,1,2,4002
0,1,1,0,1,1,2,4003
1,0,1,0,0,0,2,4004
0,0,0,0,0,0,2,4005
0,1,1,0,0,0,2,4006
97,281,378,9,23,32,2,4007
1,0,1,0,0,0,2,4008
1,4,5,0,0,0,2,4009
1,2,3,0,0,0,2,4010
0,0,0,0,0,0,2,4011
1,0,1,0,0,0,2,4012
2,2,4,1,0,1,2,4013
0,1,1,0,0,0,2,4014
0,0,0,0,0,0,2,4015
1,0,1,0,0,0,2,4016
1,1,2,1,1,2,2,4017
27,41,68,0,2,2,2,4018
17,47,64,1,2,3,2,4019
4,11,15,2,3,5,2,4020
3,1,4,0,0,0,2,4021
1,3,4,0,0,0,2,4022
7,28,35,0,5,5,2,4023
0,0,0,0,0,0,2,4024
1,1,2,0,0,0,2,4025
0,0,0,0,0,0,2,4026
1,11,12,1,4,5,2,4027
3,0,3,0,0,0,2,4028
1,1,2,0,0,0,2,4029
0,0,0,0,0,0,2,4030
0,2,2,0,1,1,2,4031
1,0,1,0,0,0,2,4032
0,0,0,0,0,0,2,4033
8,2,10,3,0,3,2,4034
26,144,170,5,32,37,2,4035
0,0,0,0,0,0,2,4036
0,1,1,0,1,1,2,4037
0,0,0,0,0,0,2,4038
0,0,0,0,0,0,2,4039
0,0,0,0,0,0,2,4040
0,0,0,0,0,0,2,4041
0,6,6,0,3,3,2,4042
1,1,2,0,1,1,2,4043
5,14,19,1,1,2,2,4044
0,0,0,0,0,0,2,4045
4,7,11,1,0,1,2,4046
8,11,19,1,0,1,2,4047
0,0,0,0,0,0,2,4048
4,0,4,0,0,0,2,4049
1,2,3,1,0,1,2,4050
29,6,35,2,1,3,2,4051
0,0,0,0,0,0,2,4052
1,0,1,0,0,0,2,4053
1,0,1,0,0,0,2,4054
0,0,0,0,0,0,2,4055
0,1,1,0,0,0,2,4056
0,0,0,0,0,0,2,4057
0,0,0,0,0,0,2,4058
1,1,2,0,0,0,2,4059
69,68,137,12,8,20,2,4060
5501,6128,11629,281,232,513,2,4061
649,1854,2503,28,64,92,2,4062
0,0,0,0,0,0,2,4063
0,0,0,0,0,0,2,4064
0,1,1,0,1,1,2,4065
0,0,0,0,0,0,2,4066
6,3,9,3,1,4,2,4067
54,26,80,9,2,11,2,4068
0,0,0,0,0,0,2,4069
1,1,2,0,0,0,2,4070
0,0,0,0,0,0,2,4071
708,2280,2988,106,207,313,2,4072
1,1,2,1,0,1,2,4073
141,124,265,20,10,30,2,4074
70,45,115,14,7,21,2,4075
3,4,7,2,0,2,2,4076
395,294,689,42,16,58,2,4077
0,0,0,0,0,0,2,4078
0,0,0,0,0,0,2,4079
8,6,14,4,0,4,2,4080
3,2,5,1,0,1,2,4081
3,3,6,0,1,1,2,4082
2,6,8,0,0,0,2,4083
0,0,0,0,0,0,2,4084
10,4,14,0,0,0,2,4085
8,5,13,1,3,4,2,4086
45,134,179,3,13,16,2,4087
5,50,55,0,10,10,2,4088
0,0,0,0,0,0,2,4089
10,6,16,1,1,2,2,4090
10,1,11,1,0,1,2,4091
5,1,6,0,0,0,2,4092
0,0,0,0,0,0,2,4093
0,0,0,0,0,0,2,4094
6,21,27,0,3,3,2,4095
18,46,64,5,5,10,2,4096
0,0,0,0,0,0,2,4097
1,2,3,0,0,0,2,4098
4,2,6,1,1,2,2,4099
2,0,2,0,0,0,2,4100
0,0,0,0,0,0,2,4101
0,1,1,0,0,0,2,4102
0,0,0,0,0,0,2,4103
0,0,0,0,0,0,2,4104
0,0,0,0,0,0,2,4105
0,0,0,0,0,0,2,4106
0,0,0,0,0,0,2,4107
0,0,0,0,0,0,2,4108
0,1,1,0,0,0,2,4109
2,1,3,0,0,0,2,4110
0,2,2,0,0,0,2,4111
0,0,0,0,0,0,2,4112
0,0,0,0,0,0,2,4113
5,2,7,2,0,2,2,4114
0,0,0,0,0,0,2,4115
0,0,0,0,0,0,2,4116
7,11,18,2,1,3,2,4117
0,0,0,0,0,0,2,4118
1,1,2,0,0,0,2,4119
3,4,7,0,0,0,2,4120
0,0,0,0,0,0,2,4121
2,1,3,0,0,0,2,4122
0,1,1,0,0,0,2,4123
1,1,2,0,0,0,2,4124
0,0,0,0,0,0,2,4125
2,1,3,0,0,0,2,4126
0,0,0,0,0,0,2,4127
0,0,0,0,0,0,2,4128
1,0,1,0,0,0,2,4129
0,0,0,0,0,0,2,4130
0,0,0,0,0,0,2,4131
1,0,1,1,0,1,2,4132
0,0,0,0,0,0,2,4133
2,3,5,0,0,0,2,4134
1,0,1,0,0,0,2,4135
0,0,0,0,0,0,2,4136
1,1,2,0,1,1,2,4137
17,47,64,0,4,4,2,4138
0,0,0,0,0,0,2,4139
0,0,0,0,0,0,2,4140
1,0,1,0,0,0,2,4141
0,0,0,0,0,0,2,4142
0,0,0,0,0,0,2,4143
3,1,4,0,0,0,2,4144
31,69,100,11,15,26,2,4145
3,11,14,0,0,0,2,4146
0,1,1,0,1,1,2,4147
0,0,0,0,0,0,2,4148
0,0,0,0,0,0,2,4149
1,2,3,0,0,0,2,4150
0,0,0,0,0,0,2,4151
3,0,3,1,0,1,2,4152
9,10,19,0,1,1,2,4153
0,0,0,0,0,0,2,4154
0,0,0,0,0,0,2,4155
0,0,0,0,0,0,2,4156
0,0,0,0,0,0,2,4157
1,0,1,0,0,0,2,4158
5,8,13,1,0,1,2,4159
1,2,3,0,0,0,2,4160
66,308,374,3,12,15,2,4161
3,3,6,0,0,0,2,4162
0,0,0,0,0,0,2,4163
0,0,0,0,0,0,2,4164
1,0,1,0,0,0,2,4165
23,6,29,3,1,4,2,4166
0,0,0,0,0,0,2,4167
0,0,0,0,0,0,2,4168
0,0,0,0,0,0,2,4169
0,0,0,0,0,0,2,4170
1,1,2,0,1,1,2,4171
0,0,0,0,0,0,2,4172
0,0,0,0,0,0,2,4173
0,0,0,0,0,0,2,4174
0,1,1,0,0,0,2,4175
0,0,0,0,0,0,2,4176
0,0,0,0,0,0,2,4177
0,0,0,0,0,0,2,4178
0,0,0,0,0,0,2,4179
0,0,0,0,0,0,2,4180
0,0,0,0,0,0,2,4181
2,2,4,0,0,0,2,4182
5,2,7,0,0,0,2,4183
0,0,0,0,0,0,2,4184
0,1,1,0,0,0,2,4185
16,41,57,3,12,15,2,4186
0,1,1,0,0,0,2,4187
3,0,3,0,0,0,2,4188
1,0,1,0,0,0,2,4189
3,0,3,0,0,0,2,4190
0,0,0,0,0,0,2,4191
0,0,0,0,0,0,2,4192
0,1,1,0,0,0,2,4193
3,0,3,0,0,0,2,4194
4,1,5,1,0,1,2,4195
16,21,37,7,2,9,2,4196
0,0,0,0,0,0,2,4197
1,0,1,0,0,0,2,4198
154,474,628,7,29,36,2,4199
2,2,4,0,2,2,2,4200
0,0,0,0,0,0,2,4201
0,0,0,0,0,0,2,4202
0,0,0,0,0,0,2,4203
0,0,0,0,0,0,2,4204
0,1,1,0,1,1,2,4205
0,0,0,0,0,0,2,4206
2,0,2,0,0,0,2,4207
0,0,0,0,0,0,2,4208
0,1,1,0,0,0,2,4209
0,1,1,0,0,0,2,4210
0,0,0,0,0,0,2,4211
0,0,0,0,0,0,2,4212
0,2,2,0,0,0,2,4213
0,0,0,0,0,0,2,4214
1,0,1,0,0,0,2,4215
0,0,0,0,0,0,2,4216
7,5,12,4,1,5,2,4217
0,4,4,0,0,0,2,4218
4,13,17,0,2,2,2,4219
4,10,14,0,2,2,2,4220
3,2,5,0,0,0,2,4221
0,0,0,0,0,0,2,4222
12,137,149,0,4,4,2,4223
0,1,1,0,0,0,2,4224
4,5,9,0,1,1,2,4225
1,2,3,0,0,0,2,4226
0,4,4,0,0,0,2,4227
19,9,28,3,1,4,2,4228
0,0,0,0,0,0,2,4229
5,5,10,0,1,1,2,4230
21,29,50,4,4,8,2,4231
2,0,2,0,0,0,2,4232
0,0,0,0,0,0,2,4233
0,0,0,0,0,0,2,4234
88,373,461,16,62,78,2,4235
0,3,3,0,0,0,2,4236
0,0,0,0,0,0,2,4237
0,0,0,0,0,0,2,4238
0,0,0,0,0,0,2,4239
1,2,3,0,1,1,2,4240
3,0,3,1,0,1,2,4241
5,0,5,1,0,1,2,4242
4,1,5,0,0,0,2,4243
3,3,6,0,2,2,2,4244
10,31,41,4,5,9,2,4245
89,183,272,17,20,37,2,4246
1,2,3,0,0,0,2,4247
19,17,36,2,3,5,2,4248
1,0,1,0,0,0,2,4249
1,0,1,0,0,0,2,4250
1,0,1,1,0,1,2,4251
2,0,2,1,0,1,2,4252
0,0,0,0,0,0,2,4253
0,0,0,0,0,0,2,4254
0,0,0,0,0,0,2,4255
1,0,1,0,0,0,2,4256
17,4,21,5,1,6,2,4257
0,0,0,0,0,0,2,4258
0,0,0,0,0,0,2,4259
1,1,2,1,0,1,2,4260
3,0,3,0,0,0,2,4261
8,4,12,1,1,2,2,4262
14,6,20,7,2,9,2,4263
3,9,12,3,5,8,2,4264
113,642,755,17,54,71,2,4265
1,0,1,1,0,1,2,4266
0,0,0,0,0,0,2,4267
0,0,0,0,0,0,2,4268
8,2,10,0,0,0,2,4269
0,1,1,0,0,0,2,4270
2,1,3,0,0,0,2,4271
61,79,140,5,14,19,2,4272
5,22,27,0,3,3,2,4273
6,0,6,1,0,1,2,4274
0,1,1,0,0,0,2,4275
0,0,0,0,0,0,2,4276
0,1,1,0,0,0,2,4277
0,0,0,0,0,0,2,4278
4,19,23,1,10,11,2,4279
1,1,2,0,0,0,2,4280
0,2,2,0,0,0,2,4281
0,0,0,0,0,0,2,4282
0,0,0,0,0,0,2,4283
19,29,48,5,1,6,2,4284
1,1,2,0,1,1,2,4285
4,1,5,0,0,0,2,4286
0,0,0,0,0,0,2,4287
0,0,0,0,0,0,2,4288
0,0,0,0,0,0,2,4289
1,0,1,1,0,1,2,4290
7,12,19,1,3,4,2,4291
1,1,2,1,0,1,2,4292
56,26,82,6,0,6,2,4293
5,2,7,0,2,2,2,4294
13,54,67,0,10,10,2,4295
5,0,5,0,0,0,2,4296
4,3,7,1,0,1,2,4297
0,1,1,0,0,0,2,4298
307,51,358,34,3,37,2,4299
1,0,1,0,0,0,2,4300
3,26,29,1,1,2,2,4301
1,0,1,0,0,0,2,4302
1,6,7,0,0,0,2,4303
85,137,222,15,8,23,2,4304
7,32,39,0,0,0,2,4305
10,6,16,0,2,2,2,4306
0,0,0,0,0,0,2,4307
0,1,1,0,0,0,2,4308
6,6,12,0,1,1,2,4309
1,6,7,0,1,1,2,4310
1,3,4,0,0,0,2,4311
4,9,13,0,0,0,2,4312
1,1,2,1,0,1,2,4313
1,0,1,0,0,0,2,4314
223,165,388,34,18,52,2,4315
1,2,3,0,0,0,2,4316
14,13,27,1,5,6,2,4317
5,15,20,1,4,5,2,4318
0,0,0,0,0,0,2,4319
0,0,0,0,0,0,2,4320
7,1,8,1,0,1,2,4321
3,6,9,0,0,0,2,4322
10,2,12,3,1,4,2,4323
3,4,7,0,0,0,2,4324
13,10,23,4,0,4,2,4325
1,8,9,0,0,0,2,4326
9,8,17,2,1,3,2,4327
1,0,1,0,0,0,2,4328
24,84,108,6,11,17,2,4329
15,11,26,15,11,26,2,4330
5,12,17,1,0,1,2,4331
1,6,7,0,0,0,2,4332
5,18,23,0,2,2,2,4333
0,0,0,0,0,0,2,4334
0,0,0,0,0,0,2,4335
1,1,2,0,0,0,2,4336
6,0,6,0,0,0,2,4337
2,0,2,0,0,0,2,4338
1,0,1,0,0,0,2,4339
0,2,2,0,0,0,2,4340
21,16,37,2,1,3,2,4341
0,0,0,0,0,0,2,4342
4,0,4,0,0,0,2,4343
0,0,0,0,0,0,2,4344
2,0,2,1,0,1,2,4345
1,0,1,0,0,0,2,4346
0,0,0,0,0,0,2,4347
0,0,0,0,0,0,2,4348
0,0,0,0,0,0,2,4349
447,570,1017,2,2,4,2,4350
0,0,0,0,0,0,2,4351
3,2,5,0,0,0,2,4352
3,4,7,0,0,0,2,4353
1,0,1,0,0,0,2,4354
0,0,0,0,0,0,2,4355
3,6,9,0,1,1,2,4356
5,17,22,1,3,4,2,4357
0,3,3,0,0,0,2,4358
5,1,6,0,0,0,2,4359
8,19,27,0,3,3,2,4360
1,1,2,0,0,0,2,4361
1,1,2,0,0,0,2,4362
0,1,1,0,0,0,2,4363
0,1,1,0,0,0,2,4364
0,1,1,0,0,0,2,4365
0,0,0,0,0,0,2,4366
0,0,0,0,0,0,2,4367
0,0,0,0,0,0,2,4368
0,0,0,0,0,0,2,4369
0,0,0,0,0,0,2,4370
0,1,1,0,1,1,2,4371
0,0,0,0,0,0,2,4372
0,0,0,0,0,0,2,4373
1,0,1,0,0,0,2,4374
2,0,2,0,0,0,2,4375
0,0,0,0,0,0,2,4376
1,2,3,0,0,0,2,4377
3,0,3,0,0,0,2,4378
6,2,8,0,1,1,2,4379
4,1,5,1,0,1,2,4380
0,0,0,0,0,0,2,4381
0,6,6,0,0,0,2,4382
1,0,1,0,0,0,2,4383
5,13,18,0,1,1,2,4384
16,6,22,7,3,10,2,4385
12,5,17,0,0,0,2,4386
0,0,0,0,0,0,2,4387
0,0,0,0,0,0,2,4388
9,5,14,2,0,2,2,4389
2,7,9,0,0,0,2,4390
9,20,29,3,3,6,2,4391
7,36,43,0,0,0,2,4392
1,0,1,0,0,0,2,4393
2,2,4,0,1,1,2,4394
0,2,2,0,1,1,2,4395
0,0,0,0,0,0,2,4396
6,6,12,2,2,4,2,4397
1,0,1,1,0,1,2,4398
5,20,25,2,4,6,2,4399
13,23,36,1,1,2,2,4400
0,0,0,0,0,0,2,4401
2,2,4,0,0,0,2,4402
2,0,2,0,0,0,2,4403
16,4,20,0,1,1,2,4404
85,389,474,1,3,4,2,4405
91,285,376,15,44,59,2,4406
18,4,22,3,1,4,2,4407
17,20,37,2,0,2,2,4408
3,5,8,0,0,0,2,4409
5,0,5,1,0,1,2,4410
1,0,1,1,0,1,2,4411
0,0,0,0,0,0,2,4412
1,2,3,0,0,0,2,4413
0,0,0,0,0,0,2,4414
0,9,9,0,0,0,2,4415
1,1,2,0,0,0,2,4416
0,1,1,0,0,0,2,4417
1,0,1,1,0,1,2,4418
1,1,2,0,0,0,2,4419
0,0,0,0,0,0,2,4420
0,1,1,0,0,0,2,4421
13,36,49,3,1,4,2,4422
3,1,4,0,0,0,2,4423
1,1,2,0,0,0,2,4424
0,8,8,0,1,1,2,4425
7,4,11,1,2,3,2,4426
3,1,4,0,0,0,2,4427
0,0,0,0,0,0,2,4428
0,1,1,0,0,0,2,4429
0,1,1,0,1,1,2,4430
2,1,3,0,0,0,2,4431
14,0,14,4,0,4,2,4432
2,1,3,0,0,0,2,4433
7,1,8,0,0,0,2,4434
2,4,6,0,1,1,2,4435
3,3,6,0,2,2,2,4436
0,0,0,0,0,0,2,4437
5,4,9,1,0,1,2,4438
4,0,4,1,0,1,2,4439
2,4,6,1,2,3,2,4440
4,3,7,1,1,2,2,4441
13,23,36,5,14,19,2,4442
2,0,2,0,0,0,2,4443
1,0,1,1,0,1,2,4444
1,1,2,1,0,1,2,4445
2,0,2,1,0,1,2,4446
0,0,0,0,0,0,2,4447
1,1,2,0,0,0,2,4448
0,0,0,0,0,0,2,4449
0,2,2,0,0,0,2,4450
0,0,0,0,0,0,2,4451
3,0,3,0,0,0,2,4452
2605,2434,5039,921,703,1624,2,4453
2094,1446,3540,745,529,1274,2,4454
4,1,5,0,0,0,2,4455
5,1,6,0,0,0,2,4456
6,55,61,4,30,34,2,4457
0,2,2,0,0,0,2,4458
2,0,2,0,0,0,2,4459
8,1,9,0,0,0,2,4460
8,9,17,0,0,0,2,4461
6,2,8,0,0,0,2,4462
0,0,0,0,0,0,2,4463
1,0,1,1,0,1,2,4464
4,3,7,0,0,0,2,4465
4,0,4,0,0,0,2,4466
4,1,5,2,0,2,2,4467
2,0,2,0,0,0,2,4468
2,0,2,0,0,0,2,4469
0,0,0,0,0,0,2,4470
2,0,2,1,0,1,2,4471
2,0,2,0,0,0,2,4472
4,3,7,0,0,0,2,4473
0,0,0,0,0,0,2,4474
18028,12624,30652,837,559,1396,2,4475
0,0,0,0,0,0,2,4476
0,2,2,0,0,0,2,4477
1,1,2,0,0,0,2,4478
33,13,46,5,6,11,2,4479
12,5,17,4,3,7,2,4480
14,12,26,1,4,5,2,4481
1,0,1,0,0,0,2,4482
0,0,0,0,0,0,2,4483
0,1,1,0,0,0,2,4484
5,1,6,0,0,0,2,4485
0,0,0,0,0,0,2,4486
2,1,3,0,0,0,2,4487
10,49,59,3,10,13,2,4488
2,0,2,0,0,0,2,4489
4,3,7,0,1,1,2,4490
2,1,3,0,0,0,2,4491
0,0,0,0,0,0,2,4492
20,13,33,6,5,11,2,4493
16,13,29,4,2,6,2,4494
2,2,4,0,0,0,2,4495
0,4,4,0,0,0,2,4496
1,1,2,0,0,0,2,4497
1,0,1,0,0,0,2,4498
2,0,2,0,0,0,2,4499
14,12,26,2,6,8,2,4500
0,0,0,0,0,0,2,4501
0,0,0,0,0,0,2,4502
10,12,22,4,5,9,2,4503
0,0,0,0,0,0,2,4504
1,0,1,1,0,1,2,4505
3,1,4,1,1,2,2,4506
19,4,23,2,0,2,2,4507
1,0,1,0,0,0,2,4508
1,1,2,0,0,0,2,4509
0,2,2,0,0,0,2,4510
0,0,0,0,0,0,2,4511
18,6,24,2,1,3,2,4512
4,6,10,0,0,0,2,4513
3,0,3,1,0,1,2,4514
1,0,1,0,0,0,2,4515
2,0,2,0,0,0,2,4516
1,2,3,0,2,2,2,4517
8,6,14,2,1,3,2,4518
3,2,5,0,0,0,2,4519
0,2,2,0,0,0,2,4520
0,0,0,0,0,0,2,4521
1,0,1,0,0,0,2,4522
0,3,3,0,2,2,2,4523
0,2,2,0,0,0,2,4524
2,0,2,1,0,1,2,4525
5,3,8,0,0,0,2,4526
1,0,1,1,0,1,2,4527
0,0,0,0,0,0,2,4528
0,0,0,0,0,0,2,4529
2,5,7,0,0,0,2,4530
1,1,2,1,1,2,2,4531
0,0,0,0,0,0,2,4532
2,1,3,1,0,1,2,4533
0,0,0,0,0,0,2,4534
1,1,2,0,0,0,2,4535
0,2,2,0,0,0,2,4536
2,0,2,0,0,0,2,4537
1,0,1,0,0,0,2,4538
1,3,4,0,1,1,2,4539
0,3,3,0,0,0,2,4540
0,0,0,0,0,0,2,4541
6,0,6,1,0,1,2,4542
7,1,8,4,1,5,2,4543
0,0,0,0,0,0,2,4544
0,0,0,0,0,0,2,4545
220,123,343,10,11,21,2,4546
1,0,1,0,0,0,2,4547
37,69,106,13,20,33,2,4548
1,8,9,1,0,1,2,4549
5,34,39,0,9,9,2,4550
0,0,0,0,0,0,2,4551
0,0,0,0,0,0,2,4552
0,2,2,0,1,1,2,4553
24,41,65,6,12,18,2,4554
25,31,56,3,8,11,2,4555
2,0,2,0,0,0,2,4556
0,0,0,0,0,0,2,4557
0,0,0,0,0,0,2,4558
0,4,4,0,1,1,2,4559
0,0,0,0,0,0,2,4560
0,2,2,0,0,0,2,4561
0,0,0,0,0,0,2,4562
1,0,1,0,0,0,2,4563
0,2,2,0,0,0,2,4564
0,0,0,0,0,0,2,4565
0,6,6,0,2,2,2,4566
1,1,2,1,1,2,2,4567
0,0,0,0,0,0,2,4568
0,5,5,0,1,1,2,4569
1,0,1,1,0,1,2,4570
2,2,4,0,0,0,2,4571
3,0,3,1,0,1,2,4572
0,1,1,0,1,1,2,4573
0,0,0,0,0,0,2,4574
0,0,0,0,0,0,2,4575
6,1,7,1,1,2,2,4576
1,0,1,1,0,1,2,4577
4,2,6,3,1,4,2,4578
1,3,4,0,0,0,2,4579
0,0,0,0,0,0,2,4580
1,0,1,1,0,1,2,4581
1,0,1,0,0,0,2,4582
0,0,0,0,0,0,2,4583
0,0,0,0,0,0,2,4584
0,0,0,0,0,0,2,4585
0,0,0,0,0,0,2,4586
0,0,0,0,0,0,2,4587
1,0,1,0,0,0,2,4588
0,3,3,0,1,1,2,4589
7,1,8,2,1,3,2,4590
0,0,0,0,0,0,2,4591
1,3,4,0,0,0,2,4592
0,1,1,0,0,0,2,4593
1,4,5,0,2,2,2,4594
7,9,16,2,2,4,2,4595
681,337,1018,358,155,513,2,4596
2162,1613,3775,573,333,906,2,4597
87,42,129,24,11,35,2,4598
17,45,62,2,14,16,2,4599
4,11,15,0,5,5,2,4600
2,1,3,0,0,0,2,4601
1,0,1,0,0,0,2,4602
12,4,16,6,0,6,2,4603
5,8,13,1,0,1,2,4604
2,0,2,0,0,0,2,4605
1,2,3,0,2,2,2,4606
2,0,2,0,0,0,2,4607
4,3,7,1,0,1,2,4608
7,2,9,0,0,0,2,4609
2,2,4,1,1,2,2,4610
2,0,2,0,0,0,2,4611
0,1,1,0,0,0,2,4612
0,2,2,0,0,0,2,4613
22,5,27,4,0,4,2,4614
7,2,9,2,0,2,2,4615
0,1,1,0,0,0,2,4616
1,1,2,1,1,2,2,4617
0,0,0,0,0,0,2,4618
1,1,2,1,1,2,2,4619
3,11,14,2,2,4,2,4620
2,11,13,1,4,5,2,4621
3,11,14,1,4,5,2,4622
16,61,77,5,18,23,2,4623
1,0,1,0,0,0,2,4624
3,4,7,0,3,3,2,4625
1,6,7,1,0,1,2,4626
1,3,4,0,1,1,2,4627
31,42,73,5,9,14,2,4628
6,0,6,2,0,2,2,4629
6,5,11,2,1,3,2,4630
2,0,2,0,0,0,2,4631
2,0,2,0,0,0,2,4632
1,0,1,0,0,0,2,4633
17,22,39,0,1,1,2,4634
25,63,88,2,6,8,2,4635
1,0,1,0,0,0,2,4636
2,7,9,1,1,2,2,4637
0,3,3,0,1,1,2,4638
2,16,18,1,3,4,2,4639
8,12,20,0,1,1,2,4640
7,7,14,0,1,1,2,4641
0,0,0,0,0,0,2,4642
0,4,4,0,0,0,2,4643
0,0,0,0,0,0,2,4644
0,1,1,0,0,0,2,4645
0,0,0,0,0,0,2,4646
0,0,0,0,0,0,2,4647
6,3,9,2,0,2,2,4648
3,11,14,1,4,5,2,4649
2,0,2,1,0,1,2,4650
2,4,6,1,2,3,2,4651
5,30,35,1,6,7,2,4652
1,1,2,1,0,1,2,4653
1,0,1,0,0,0,2,4654
0,1,1,0,0,0,2,4655
0,0,0,0,0,0,2,4656
91,256,347,14,34,48,2,4657
0,1,1,0,0,0,2,4658
3,4,7,2,2,4,2,4659
2,2,4,1,0,1,2,4660
3,0,3,2,0,2,2,4661
0,2,2,0,0,0,2,4662
4,6,10,1,1,2,2,4663
17,125,142,3,7,10,2,4664
3,1,4,0,0,0,2,4665
134,43,177,30,5,35,2,4666
99,89,188,11,23,34,2,4667
1,4,5,0,0,0,2,4668
0,0,0,0,0,0,2,4669
6,22,28,1,9,10,2,4670
28,10,38,11,7,18,2,4671
0,4,4,0,4,4,2,4672
0,0,0,0,0,0,2,4673
4,0,4,0,0,0,2,4674
0,0,0,0,0,0,2,4675
1,1,2,0,0,0,2,4676
0,0,0,0,0,0,2,4677
0,0,0,0,0,0,2,4678
0,0,0,0,0,0,2,4679
1,2,3,0,0,0,2,4680
1,0,1,1,0,1,2,4681
2,0,2,0,0,0,2,4682
0,0,0,0,0,0,2,4683
0,0,0,0,0,0,2,4684
130,178,308,3,11,14,2,4685
194,181,375,5,5,10,2,4686
31,11,42,7,2,9,2,4687
1,6,7,0,1,1,2,4688
1,0,1,1,0,1,2,4689
4,1,5,0,0,0,2,4690
2,5,7,1,0,1,2,4691
0,0,0,0,0,0,2,4692
11,30,41,1,4,5,2,4693
1,0,1,1,0,1,2,4694
0,0,0,0,0,0,2,4695
0,0,0,0,0,0,2,4696
4,5,9,1,0,1,2,4697
3,0,3,1,0,1,2,4698
3,0,3,0,0,0,2,4699
6,4,10,1,1,2,2,4700
10,10,20,3,2,5,2,4701
7,2,9,0,1,1,2,4702
1,0,1,0,0,0,2,4703
0,0,0,0,0,0,2,4704
86,101,187,13,30,43,2,4705
2,7,9,0,1,1,2,4706
8,1,9,1,0,1,2,4707
0,0,0,0,0,0,2,4708
2,1,3,1,0,1,2,4709
3,16,19,2,4,6,2,4710
2,0,2,0,0,0,2,4711
1,0,1,0,0,0,2,4712
3,0,3,1,0,1,2,4713
0,0,0,0,0,0,2,4714
1,2,3,0,0,0,2,4715
15,21,36,10,5,15,2,4716
2,0,2,0,0,0,2,4717
3,0,3,0,0,0,2,4718
0,0,0,0,0,0,2,4719
0,0,0,0,0,0,2,4720
0,0,0,0,0,0,2,4721
4,2,6,2,1,3,2,4722
3,0,3,0,0,0,2,4723
0,0,0,0,0,0,2,4724
0,0,0,0,0,0,2,4725
0,0,0,0,0,0,2,4726
0,0,0,0,0,0,2,4727
2,4,6,1,3,4,2,4728
1,0,1,0,0,0,2,4729
0,0,0,0,0,0,2,4730
0,0,0,0,0,0,2,4731
0,0,0,0,0,0,2,4732
0,0,0,0,0,0,2,4733
0,0,0,0,0,0,2,4734
0,0,0,0,0,0,2,4735
2,1,3,1,1,2,2,4736
1,1,2,0,0,0,2,4737
0,0,0,0,0,0,2,4738
1,0,1,0,0,0,2,4739
0,0,0,0,0,0,2,4740
1,2,3,1,2,3,2,4741
0,0,0,0,0,0,2,4742
0,0,0,0,0,0,2,4743
0,0,0,0,0,0,2,4744
1,0,1,1,0,1,2,4745
6,1,7,0,0,0,2,4746
1,1,2,0,0,0,2,4747
0,3,3,0,0,0,2,4748
1,0,1,0,0,0,2,4749
0,0,0,0,0,0,2,4750
0,0,0,0,0,0,2,4751
0,1,1,0,1,1,2,4752
0,0,0,0,0,0,2,4753
0,0,0,0,0,0,2,4754
1,0,1,0,0,0,2,4755
7,5,12,1,5,6,2,4756
0,0,0,0,0,0,2,4757
0,0,0,0,0,0,2,4758
0,0,0,0,0,0,2,4759
0,0,0,0,0,0,2,4760
1,3,4,1,1,2,2,4761
0,0,0,0,0,0,2,4762
0,0,0,0,0,0,2,4763
0,0,0,0,0,0,2,4764
1,1,2,0,1,1,2,4765
0,0,0,0,0,0,2,4766
0,0,0,0,0,0,2,4767
0,1,1,0,0,0,2,4768
0,0,0,0,0,0,2,4769
0,0,0,0,0,0,2,4770
0,0,0,0,0,0,2,4771
2,3,5,0,2,2,2,4772
0,0,0,0,0,0,2,4773
0,0,0,0,0,0,2,4774
0,0,0,0,0,0,2,4775
0,0,0,0,0,0,2,4776
0,0,0,0,0,0,2,4777
2,0,2,0,0,0,2,4778
0,0,0,0,0,0,2,4779
0,1,1,0,0,0,2,4780
1,0,1,1,0,1,2,4781
2,1,3,2,1,3,2,4782
0,0,0,0,0,0,2,4783
0,0,0,0,0,0,2,4784
0,1,1,0,0,0,2,4785
0,0,0,0,0,0,2,4786
0,0,0,0,0,0,2,4787
0,0,0,0,0,0,2,4788
0,0,0,0,0,0,2,4789
1,0,1,0,0,0,2,4790
1,2,3,1,1,2,2,4791
0,1,1,0,0,0,2,4792
1,3,4,0,1,1,2,4793
0,0,0,0,0,0,2,4794
0,0,0,0,0,0,2,4795
0,0,0,0,0,0,2,4796
1,0,1,1,0,1,2,4797
1,8,9,1,5,6,2,4798
0,0,0,0,0,0,2,4799
6,3,9,2,3,5,2,4800
0,0,0,0,0,0,2,4801
3,10,13,3,5,8,2,4802
0,1,1,0,0,0,2,4803
0,0,0,0,0,0,2,4804
1,2,3,1,2,3,2,4805
1,0,1,1,0,1,2,4806
0,0,0,0,0,0,2,4807
12,7,19,5,5,10,2,4808
25,13,38,11,5,16,2,4809
0,0,0,0,0,0,2,4810
0,7,7,0,5,5,2,4811
0,0,0,0,0,0,2,4812
1,0,1,1,0,1,2,4813
0,0,0,0,0,0,2,4814
15,0,15,12,0,12,2,4815
0,0,0,0,0,0,2,4816
52,2,54,12,1,13,2,4817
3,1,4,2,1,3,2,4818
0,0,0,0,0,0,2,4819
1,0,1,0,0,0,2,4820
1,0,1,1,0,1,2,4821
0,0,0,0,0,0,2,4822
0,0,0,0,0,0,2,4823
0,0,0,0,0,0,2,4824
3,3,6,1,2,3,2,4825
6,7,13,0,0,0,2,4826
2,2,4,1,0,1,2,4827
0,0,0,0,0,0,2,4828
0,0,0,0,0,0,2,4829
296,174,470,191,116,307,2,4830
0,0,0,0,0,0,2,4831
109,257,366,68,171,239,2,4832
0,0,0,0,0,0,2,4833
0,0,0,0,0,0,2,4834
1,0,1,1,0,1,2,4835
0,0,0,0,0,0,2,4836
0,0,0,0,0,0,2,4837
9,14,23,6,7,13,2,4838
7,9,16,7,5,12,2,4839
0,0,0,0,0,0,2,4840
1,1,2,0,1,1,2,4841
0,1,1,0,1,1,2,4842
1,0,1,0,0,0,2,4843
2,1,3,2,0,2,2,4844
0,0,0,0,0,0,2,4845
0,0,0,0,0,0,2,4846
0,0,0,0,0,0,2,4847
0,0,0,0,0,0,2,4848
0,0,0,0,0,0,2,4849
0,0,0,0,0,0,2,4850
0,2,2,0,2,2,2,4851
0,4,4,0,1,1,2,4852
1,0,1,0,0,0,2,4853
0,1,1,0,1,1,2,4854
0,1,1,0,1,1,2,4855
0,0,0,0,0,0,2,4856
0,0,0,0,0,0,2,4857
0,0,0,0,0,0,2,4858
1,0,1,1,0,1,2,4859
0,0,0,0,0,0,2,4860
0,0,0,0,0,0,2,4861
0,0,0,0,0,0,2,4862
0,0,0,0,0,0,2,4863
0,0,0,0,0,0,2,4864
0,0,0,0,0,0,2,4865
1,0,1,1,0,1,2,4866
1,0,1,1,0,1,2,4867
0,0,0,0,0,0,2,4868
0,0,0,0,0,0,2,4869
0,0,0,0,0,0,2,4870
0,0,0,0,0,0,2,4871
0,0,0,0,0,0,2,4872
1,0,1,1,0,1,2,4873
0,0,0,0,0,0,2,4874
3,0,3,3,0,3,2,4875
0,0,0,0,0,0,2,4876
0,0,0,0,0,0,2,4877
0,0,0,0,0,0,2,4878
8,3,11,8,3,11,2,4879
0,4,4,0,4,4,2,4880
0,1,1,0,1,1,2,4881
2,0,2,2,0,2,2,4882
9,18,27,9,18,27,2,4883
0,0,0,0,0,0,2,4884
0,1,1,0,1,1,2,4885
0,0,0,0,0,0,2,4886
0,0,0,0,0,0,2,4887
0,0,0,0,0,0,2,4888
0,0,0,0,0,0,2,4889
0,0,0,0,0,0,2,4890
1,0,1,1,0,1,2,4891
0,0,0,0,0,0,2,4892
0,0,0,0,0,0,2,4893
0,0,0,0,0,0,2,4894
0,0,0,0,0,0,2,4895
0,0,0,0,0,0,2,4896
2,0,2,2,0,2,2,4897
0,0,0,0,0,0,2,4898
0,2,2,0,2,2,2,4899
0,0,0,0,0,0,2,4900
0,0,0,0,0,0,2,4901
2,6,8,2,6,8,2,4902
3,3,6,3,3,6,2,4903
2,0,2,2,0,2,2,4904
1,0,1,1,0,1,2,4905
0,0,0,0,0,0,2,4906
1,2,3,1,2,3,2,4907
0,0,0,0,0,0,2,4908
2,0,2,2,0,2,2,4909
1,2,3,1,2,3,2,4910
0,1,1,0,1,1,2,4911
3,0,3,3,0,3,2,4912
0,1,1,0,1,1,2,4913
0,0,0,0,0,0,2,4914
0,0,0,0,0,0,2,4915
0,0,0,0,0,0,2,4916
0,0,0,0,0,0,2,4917
0,0,0,0,0,0,2,4918
0,0,0,0,0,0,2,4919
0,0,0,0,0,0,2,4920
0,0,0,0,0,0,2,4921
0,0,0,0,0,0,2,4922
5,1,6,5,1,6,2,4923
1,0,1,1,0,1,2,4924
0,0,0,0,0,0,2,4925
0,0,0,0,0,0,2,4926
0,0,0,0,0,0,2,4927
0,0,0,0,0,0,2,4928
0,0,0,0,0,0,2,4929
0,0,0,0,0,0,2,4930
0,0,0,0,0,0,2,4931
0,0,0,0,0,0,2,4932
0,0,0,0,0,0,2,4933
0,0,0,0,0,0,2,4934
0,0,0,0,0,0,2,4935
0,0,0,0,0,0,2,4936
0,0,0,0,0,0,2,4937
0,0,0,0,0,0,2,4938
0,0,0,0,0,0,2,4939
0,0,0,0,0,0,2,4940
0,0,0,0,0,0,2,4941
0,0,0,0,0,0,2,4942
0,0,0,0,0,0,2,4943
0,0,0,0,0,0,2,4944
0,0,0,0,0,0,2,4945
0,0,0,0,0,0,2,4946
1,0,1,1,0,1,2,4947
2831,582,3413,29,2,31,3,1
9,1,10,0,0,0,3,2
8,3,11,0,0,0,3,3
86,32,118,0,0,0,3,4
99,48,147,1,0,1,3,5
20,20,40,0,0,0,3,6
24,13,37,0,0,0,3,7
122,37,159,0,0,0,3,8
18,3,21,0,0,0,3,9
15,3,18,0,0,0,3,10
686,369,1055,1,2,3,3,11
209,109,318,1,3,4,3,12
1339,1419,2758,13,6,19,3,13
2085,1190,3275,19,7,26,3,14
5616,6032,11648,83,76,159,3,15
2742,1492,4234,22,14,36,3,16
6100,4438,10538,20,20,40,3,17
2910,1585,4495,13,10,23,3,18
2079,1561,3640,17,45,62,3,19
49633,31982,81615,185,154,339,3,20
24700,12746,37446,180,115,295,3,21
26550,13570,40120,271,190,461,3,22
881,1210,2091,3,8,11,3,23
976,206,1182,0,0,0,3,24
27,16,43,0,0,0,3,25
18,9,27,0,0,0,3,26
447,912,1359,3,0,3,3,27
38,10,48,0,0,0,3,28
38,49,87,0,0,0,3,29
47,47,94,0,1,1,3,30
314,206,520,1,0,1,3,31
8,4,12,0,0,0,3,32
13,3,16,0,0,0,3,33
18,16,34,0,0,0,3,34
161,376,537,1,1,2,3,35
107,51,158,0,0,0,3,36
2974,1218,4192,20,12,32,3,37
23,6,29,0,0,0,3,38
501,320,821,2,3,5,3,39
347,120,467,2,1,3,3,40
40,11,51,1,0,1,3,41
1575,1818,3393,3,2,5,3,42
17,0,17,0,0,0,3,43
5,2,7,0,0,0,3,44
46,20,66,0,0,0,3,45
123,52,175,3,2,5,3,46
17,11,28,0,0,0,3,47
19107,9375,28482,74,41,115,3,48
1296,928,2224,15,11,26,3,49
8,13,21,0,2,2,3,50
16,22,38,0,1,1,3,51
64,42,106,1,0,1,3,52
206,84,290,3,1,4,3,53
243,200,443,0,0,0,3,54
80,143,223,0,1,1,3,55
116,145,261,1,2,3,3,56
240,420,660,1,1,2,3,57
493,241,734,2,0,2,3,58
692,252,944,0,0,0,3,59
281,236,517,2,1,3,3,60
625,529,1154,6,6,12,3,61
466,266,732,5,2,7,3,62
163,57,220,0,1,1,3,63
15,6,21,0,0,0,3,64
16,13,29,0,0,0,3,65
263,249,512,0,0,0,3,66
5157,3362,8519,10,6,16,3,67
6443,10142,16585,12,19,31,3,68
24,5,29,0,0,0,3,69
5,3,8,0,0,0,3,70
42,6,48,1,1,2,3,71
1,6,7,0,0,0,3,72
602,1008,1610,9,8,17,3,73
22,3,25,0,0,0,3,74
136,160,296,0,0,0,3,75
73,312,385,1,1,2,3,76
323,202,525,0,0,0,3,77
109,241,350,0,0,0,3,78
41,55,96,0,1,1,3,79
6,2,8,0,0,0,3,80
51,11,62,0,1,1,3,81
3,1,4,0,0,0,3,82
9,2,11,0,0,0,3,83
5,4,9,0,0,0,3,84
1,3,4,0,0,0,3,85
0,0,0,0,0,0,3,86
4,2,6,0,0,0,3,87
6,6,12,0,0,0,3,88
60,47,107,0,1,1,3,89
61,25,86,0,0,0,3,90
83,45,128,0,1,1,3,91
30,15,45,0,0,0,3,92
8,2,10,0,0,0,3,93
63,54,117,1,0,1,3,94
17,9,26,1,0,1,3,95
23,30,53,0,0,0,3,96
5,3,8,0,0,0,3,97
7,1,8,0,0,0,3,98
0,3,3,0,0,0,3,99
128078,41160,169238,182,68,250,3,100
234,31,265,4,1,5,3,101
27,9,36,0,0,0,3,102
5,3,8,1,0,1,3,103
15,3,18,0,0,0,3,104
52,9,61,0,0,0,3,105
513,323,836,2,2,4,3,106
108,82,190,2,0,2,3,107
179,54,233,0,1,1,3,108
163,92,255,0,1,1,3,109
240,394,634,3,1,4,3,110
2,5,7,0,0,0,3,111
72,15,87,1,0,1,3,112
79,92,171,0,0,0,3,113
41,45,86,0,1,1,3,114
56,16,72,0,1,1,3,115
16,16,32,1,0,1,3,116
5,1,6,0,0,0,3,117
39,20,59,0,0,0,3,118
3,2,5,0,0,0,3,119
1,2,3,0,0,0,3,120
3,4,7,0,0,0,3,121
7,16,23,0,2,2,3,122
1757,425,2182,15,4,19,3,123
829,1133,1962,9,6,15,3,124
16,20,36,0,1,1,3,125
481,1017,1498,5,2,7,3,126
77,76,153,1,4,5,3,127
584,831,1415,11,7,18,3,128
13,6,19,0,0,0,3,129
13,5,18,0,0,0,3,130
117,74,191,3,0,3,3,131
19,17,36,1,0,1,3,132
102,58,160,2,0,2,3,133
24539,25389,49928,48,79,127,3,134
89,69,158,1,1,2,3,135
346,157,503,3,3,6,3,136
12,9,21,0,0,0,3,137
6,9,15,0,0,0,3,138
336,106,442,1,0,1,3,139
59,74,133,0,1,1,3,140
31,5,36,0,0,0,3,141
11,42,53,0,0,0,3,142
132,28,160,1,0,1,3,143
37,7,44,0,0,0,3,144
114,73,187,2,0,2,3,145
183,150,333,0,0,0,3,146
26650,26483,53133,259,193,452,3,147
24,22,46,0,0,0,3,148
32,60,92,0,0,0,3,149
20,14,34,4,0,4,3,150
55,14,69,0,0,0,3,151
333,219,552,6,6,12,3,152
27,6,33,0,0,0,3,153
69,38,107,0,1,1,3,154
6,3,9,0,0,0,3,155
58,2,60,1,0,1,3,156
39,76,115,0,1,1,3,157
1010,731,1741,2,1,3,3,158
27,5,32,0,0,0,3,159
58,12,70,1,0,1,3,160
367,542,909,1,1,2,3,161
56,13,69,1,0,1,3,162
3,6,9,0,0,0,3,163
7,4,11,0,2,2,3,164
6,9,15,0,0,0,3,165
2,5,7,0,0,0,3,166
15,6,21,0,0,0,3,167
7,7,14,0,0,0,3,168
144,233,377,1,1,2,3,169
17,28,45,0,0,0,3,170
43,154,197,0,1,1,3,171
13,6,19,0,0,0,3,172
25,4,29,0,0,0,3,173
22,8,30,0,0,0,3,174
115,172,287,1,1,2,3,175
44,19,63,0,0,0,3,176
100,47,147,1,0,1,3,177
10,37,47,0,0,0,3,178
32,35,67,0,0,0,3,179
530,1105,1635,2,8,10,3,180
117,174,291,0,2,2,3,181
164,180,344,0,1,1,3,182
13,6,19,0,0,0,3,183
1241,4723,5964,19,35,54,3,184
39,153,192,0,0,0,3,185
335,44,379,8,1,9,3,186
299,25,324,2,0,2,3,187
66,110,176,2,1,3,3,188
94,36,130,1,0,1,3,189
67,38,105,0,1,1,3,190
15,10,25,1,0,1,3,191
141,52,193,0,0,0,3,192
917,1688,2605,0,1,1,3,193
32,9,41,0,0,0,3,194
15,5,20,0,0,0,3,195
41,6,47,0,0,0,3,196
8,2,10,0,0,0,3,197
18,6,24,0,0,0,3,198
22,12,34,0,0,0,3,199
76,19,95,0,0,0,3,200
12886,13916,26802,40,28,68,3,201
17,6,23,0,0,0,3,202
42,14,56,0,1,1,3,203
9,0,9,0,0,0,3,204
404,376,780,2,0,2,3,205
38,68,106,0,0,0,3,206
34,13,47,0,0,0,3,207
3545,842,4387,35,5,40,3,208
14,4,18,0,0,0,3,209
3,0,3,0,0,0,3,210
46,17,63,1,0,1,3,211
52,57,109,0,0,0,3,212
22,5,27,0,0,0,3,213
41,12,53,1,0,1,3,214
8,16,24,0,0,0,3,215
13,7,20,0,0,0,3,216
13,7,20,0,0,0,3,217
10,5,15,0,0,0,3,218
17,0,17,0,0,0,3,219
11,8,19,0,0,0,3,220
63,247,310,0,1,1,3,221
84,41,125,1,0,1,3,222
434,130,564,3,1,4,3,223
196,84,280,2,1,3,3,224
10,5,15,1,0,1,3,225
9,1,10,0,0,0,3,226
10,9,19,0,0,0,3,227
209,36,245,2,0,2,3,228
569,23,592,1,0,1,3,229
162,28,190,2,0,2,3,230
175,15,190,0,0,0,3,231
9,0,9,0,0,0,3,232
111,82,193,2,0,2,3,233
15,6,21,0,0,0,3,234
41,16,57,0,0,0,3,235
168,936,1104,1,10,11,3,236
298,321,619,3,2,5,3,237
48,358,406,0,5,5,3,238
30,124,154,0,0,0,3,239
24,123,147,0,1,1,3,240
54,30,84,0,0,0,3,241
108,135,243,0,1,1,3,242
4,3,7,0,0,0,3,243
55,13,68,0,0,0,3,244
37,31,68,0,0,0,3,245
5,4,9,0,0,0,3,246
3,0,3,0,0,0,3,247
24,5,29,0,0,0,3,248
4,3,7,0,0,0,3,249
8,15,23,0,0,0,3,250
6,4,10,0,0,0,3,251
16,13,29,0,0,0,3,252
5,10,15,0,0,0,3,253
2,14,16,0,0,0,3,254
4,1,5,0,0,0,3,255
2,1,3,0,0,0,3,256
5,0,5,0,0,0,3,257
3,3,6,0,0,0,3,258
1,0,1,0,0,0,3,259
1,2,3,0,0,0,3,260
1,1,2,0,0,0,3,261
17,18,35,0,0,0,3,262
221,179,400,0,1,1,3,263
33,15,48,0,0,0,3,264
88,50,138,0,1,1,3,265
22,29,51,0,0,0,3,266
19,6,25,0,0,0,3,267
3,4,7,0,0,0,3,268
1,2,3,0,0,0,3,269
5,1,6,0,0,0,3,270
4,3,7,0,0,0,3,271
44,10,54,0,0,0,3,272
5,5,10,0,0,0,3,273
27,7,34,0,0,0,3,274
4,0,4,0,0,0,3,275
1,1,2,0,0,0,3,276
5,0,5,1,0,1,3,277
2,0,2,0,0,0,3,278
5,0,5,0,0,0,3,279
0,0,0,0,0,0,3,280
21,11,32,1,0,1,3,281
54,52,106,0,0,0,3,282
197,250,447,10,10,20,3,283
52,141,193,1,1,2,3,284
30,19,49,0,1,1,3,285
21,11,32,0,0,0,3,286
6,10,16,0,0,0,3,287
35,38,73,0,0,0,3,288
6,10,16,0,0,0,3,289
1175,369,1544,11,3,14,3,290
14,7,21,0,0,0,3,291
13,3,16,0,0,0,3,292
162,47,209,1,0,1,3,293
8,8,16,0,0,0,3,294
59,22,81,0,0,0,3,295
14,9,23,0,0,0,3,296
26,25,51,1,0,1,3,297
11,14,25,0,0,0,3,298
5,5,10,0,0,0,3,299
8,16,24,0,0,0,3,300
8,9,17,0,0,0,3,301
15,15,30,0,1,1,3,302
2,14,16,0,0,0,3,303
3,10,13,0,0,0,3,304
15,12,27,0,0,0,3,305
20,13,33,0,0,0,3,306
12,18,30,0,0,0,3,307
36,47,83,2,0,2,3,308
4,5,9,0,0,0,3,309
1,7,8,0,0,0,3,310
23,17,40,0,0,0,3,311
69,32,101,0,0,0,3,312
16,12,28,0,1,1,3,313
9,4,13,0,0,0,3,314
27,41,68,0,0,0,3,315
0,0,0,0,0,0,3,316
399,224,623,1,0,1,3,317
144,257,401,3,5,8,3,318
6,19,25,0,0,0,3,319
10,96,106,0,1,1,3,320
45,32,77,2,0,2,3,321
27,20,47,0,0,0,3,322
23,11,34,1,0,1,3,323
11,13,24,0,0,0,3,324
12,6,18,0,0,0,3,325
6,30,36,0,0,0,3,326
27,87,114,0,0,0,3,327
106,82,188,0,0,0,3,328
11,4,15,0,0,0,3,329
33,54,87,0,1,1,3,330
13,48,61,0,0,0,3,331
11,24,35,0,1,1,3,332
15,5,20,0,0,0,3,333
18,4,22,0,0,0,3,334
145,151,296,0,2,2,3,335
8,6,14,0,0,0,3,336
1,7,8,0,0,0,3,337
11,4,15,0,0,0,3,338
4,1,5,0,0,0,3,339
34,48,82,0,0,0,3,340
42,73,115,0,0,0,3,341
9,4,13,0,1,1,3,342
1,0,1,0,0,0,3,343
9,5,14,0,0,0,3,344
18,23,41,1,0,1,3,345
32,12,44,0,0,0,3,346
10,10,20,0,0,0,3,347
5,10,15,0,0,0,3,348
15,30,45,1,0,1,3,349
1,0,1,0,0,0,3,350
1,2,3,0,0,0,3,351
0,0,0,0,0,0,3,352
1,3,4,0,0,0,3,353
0,0,0,0,0,0,3,354
6,7,13,0,0,0,3,355
7,0,7,0,0,0,3,356
0,0,0,0,0,0,3,357
0,0,0,0,0,0,3,358
5,8,13,0,2,2,3,359
2,1,3,0,0,0,3,360
1,1,2,0,0,0,3,361
3,1,4,0,0,0,3,362
27,88,115,1,3,4,3,363
45,88,133,2,3,5,3,364
8,8,16,0,0,0,3,365
13,13,26,0,0,0,3,366
20,79,99,1,1,2,3,367
2,9,11,1,0,1,3,368
10,3,13,0,0,0,3,369
2,2,4,0,0,0,3,370
1,0,1,0,0,0,3,371
5,0,5,0,0,0,3,372
20,72,92,0,0,0,3,373
18,3,21,0,0,0,3,374
24,10,34,1,0,1,3,375
1,6,7,0,0,0,3,376
1,1,2,0,0,0,3,377
4,4,8,0,0,0,3,378
591,48,639,5,6,11,3,379
9,5,14,1,0,1,3,380
2,1,3,0,0,0,3,381
25,6,31,0,0,0,3,382
52,18,70,1,0,1,3,383
22,6,28,1,0,1,3,384
5,2,7,0,0,0,3,385
3,0,3,0,0,0,3,386
22,8,30,0,0,0,3,387
12,11,23,0,0,0,3,388
24,27,51,0,0,0,3,389
207,51,258,2,0,2,3,390
73,54,127,0,0,0,3,391
93,33,126,0,0,0,3,392
12,7,19,0,0,0,3,393
11,28,39,0,1,1,3,394
4,6,10,0,0,0,3,395
13,3,16,0,0,0,3,396
3,0,3,0,0,0,3,397
14,7,21,1,1,2,3,398
8,42,50,0,5,5,3,399
6,7,13,0,0,0,3,400
1,0,1,0,0,0,3,401
4,1,5,0,0,0,3,402
1,7,8,0,0,0,3,403
0,0,0,0,0,0,3,404
2,0,2,0,0,0,3,405
0,1,1,0,0,0,3,406
21,25,46,0,1,1,3,407
2,1,3,0,0,0,3,408
5,12,17,0,0,0,3,409
42,22,64,3,0,3,3,410
4,16,20,0,0,0,3,411
6,4,10,0,0,0,3,412
16,12,28,0,0,0,3,413
43,39,82,0,0,0,3,414
35,99,134,1,2,3,3,415
1,2,3,0,0,0,3,416
2,5,7,0,0,0,3,417
146,58,204,5,3,8,3,418
57,45,102,2,0,2,3,419
98,37,135,0,0,0,3,420
6,1,7,0,0,0,3,421
0,1,1,0,0,0,3,422
3,2,5,0,0,0,3,423
6,8,14,0,0,0,3,424
0,2,2,0,0,0,3,425
3,0,3,0,0,0,3,426
8,18,26,0,0,0,3,427
6,0,6,0,0,0,3,428
83,202,285,0,9,9,3,429
28,85,113,0,4,4,3,430
4,22,26,0,2,2,3,431
18,20,38,1,1,2,3,432
18,87,105,0,1,1,3,433
16,4,20,0,0,0,3,434
22,4,26,0,0,0,3,435
8,3,11,0,0,0,3,436
8,0,8,0,0,0,3,437
0,0,0,0,0,0,3,438
5,15,20,0,0,0,3,439
16,10,26,0,0,0,3,440
6,0,6,0,0,0,3,441
7,14,21,0,0,0,3,442
10,10,20,0,0,0,3,443
2,4,6,0,0,0,3,444
13,3,16,0,0,0,3,445
32,4,36,0,0,0,3,446
1434,605,2039,10,3,13,3,447
536,189,725,5,2,7,3,448
473,174,647,3,3,6,3,449
374,78,452,7,0,7,3,450
101,494,595,0,1,1,3,451
9,34,43,0,0,0,3,452
0,0,0,0,0,0,3,453
65,31,96,0,0,0,3,454
3,7,10,0,0,0,3,455
13,0,13,0,0,0,3,456
492,83,575,0,1,1,3,457
12,5,17,0,0,0,3,458
4,2,6,0,0,0,3,459
1,1,2,0,0,0,3,460
7,5,12,0,0,0,3,461
8,1,9,0,0,0,3,462
20,6,26,0,0,0,3,463
4,1,5,0,0,0,3,464
33,4,37,0,0,0,3,465
56,53,109,0,1,1,3,466
962,5011,5973,15,51,66,3,467
10,69,79,0,1,1,3,468
43,55,98,0,0,0,3,469
100,11,111,0,0,0,3,470
6,6,12,0,0,0,3,471
11,2,13,0,0,0,3,472
7,2,9,1,1,2,3,473
17,10,27,0,0,0,3,474
21,10,31,0,1,1,3,475
4,0,4,0,0,0,3,476
0,2,2,0,0,0,3,477
13,2,15,0,0,0,3,478
32,22,54,0,0,0,3,479
12,5,17,0,0,0,3,480
507,308,815,5,1,6,3,481
12,4,16,0,0,0,3,482
7,3,10,0,0,0,3,483
26,6,32,0,0,0,3,484
21,1,22,0,0,0,3,485
1,2,3,0,0,0,3,486
46,16,62,0,0,0,3,487
178,212,390,2,3,5,3,488
4,2,6,0,0,0,3,489
3,3,6,0,0,0,3,490
2,0,2,0,0,0,3,491
7,10,17,0,0,0,3,492
3,5,8,0,0,0,3,493
180,422,602,1,4,5,3,494
187,490,677,2,3,5,3,495
3,2,5,0,0,0,3,496
4,4,8,0,0,0,3,497
16,32,48,0,0,0,3,498
69,103,172,2,1,3,3,499
33,29,62,0,0,0,3,500
4,0,4,0,0,0,3,501
12,8,20,0,0,0,3,502
11,7,18,0,0,0,3,503
0,3,3,0,1,1,3,504
5,1,6,0,0,0,3,505
3,0,3,0,0,0,3,506
9,3,12,0,0,0,3,507
5,2,7,0,0,0,3,508
12,10,22,0,1,1,3,509
15,4,19,0,0,0,3,510
16,3,19,0,0,0,3,511
469,985,1454,37,55,92,3,512
125,459,584,1,7,8,3,513
11,11,22,0,0,0,3,514
5,0,5,0,0,0,3,515
1364,162,1526,12,1,13,3,516
48,30,78,0,0,0,3,517
12,4,16,0,0,0,3,518
6,0,6,0,0,0,3,519
10,1,11,0,0,0,3,520
16,4,20,0,0,0,3,521
13,2,15,0,0,0,3,522
39,36,75,0,0,0,3,523
23,18,41,0,0,0,3,524
55,9,64,0,0,0,3,525
33,1,34,0,0,0,3,526
25,11,36,0,0,0,3,527
51635,47909,99544,274,220,494,3,528
414,798,1212,2,3,5,3,529
1565,3146,4711,3,7,10,3,530
309,716,1025,1,1,2,3,531
23233,52434,75667,87,185,272,3,532
5115,16112,21227,4,12,16,3,533
16065,43171,59236,53,178,231,3,534
3798,6919,10717,26,45,71,3,535
5991,13837,19828,29,59,88,3,536
3911,11131,15042,32,104,136,3,537
111,174,285,1,1,2,3,538
99,90,189,1,2,3,3,539
997,984,1981,7,12,19,3,540
433,521,954,5,5,10,3,541
1430,883,2313,6,4,10,3,542
965,627,1592,4,4,8,3,543
888,509,1397,3,9,12,3,544
66,54,120,0,0,0,3,545
485,629,1114,5,8,13,3,546
234,285,519,0,0,0,3,547
2680,3049,5729,35,39,74,3,548
5,5,10,0,0,0,3,549
8,4,12,0,0,0,3,550
10,4,14,0,0,0,3,551
5,2,7,0,0,0,3,552
9,3,12,0,0,0,3,553
35,10,45,1,1,2,3,554
12,0,12,0,0,0,3,555
24,2,26,0,0,0,3,556
2,0,2,0,0,0,3,557
161,19,180,1,0,1,3,558
2,2,4,0,0,0,3,559
3,3,6,0,0,0,3,560
17,2,19,0,0,0,3,561
2,4,6,0,0,0,3,562
2,1,3,0,0,0,3,563
7,2,9,0,0,0,3,564
4,4,8,0,0,0,3,565
12,4,16,0,1,1,3,566
5,2,7,0,0,0,3,567
4,3,7,0,0,0,3,568
12,3,15,0,0,0,3,569
28,34,62,0,0,0,3,570
6,3,9,0,0,0,3,571
4,12,16,1,0,1,3,572
0,0,0,-8,-21,-29,3,573
1,0,1,0,0,0,3,574
35,9,44,0,0,0,3,575
11,3,14,0,0,0,3,576
0,0,0,0,0,0,3,577
5,10,15,0,0,0,3,578
58,118,176,0,3,3,3,579
4,22,26,0,2,2,3,580
5,21,26,0,0,0,3,581
58,22,80,0,0,0,3,582
6,4,10,0,0,0,3,583
6,4,10,0,0,0,3,584
27,10,37,0,0,0,3,585
3,13,16,0,0,0,3,586
9,3,12,0,0,0,3,587
30,25,55,0,0,0,3,588
20,18,38,1,1,2,3,589
19,54,73,0,0,0,3,590
14,23,37,0,0,0,3,591
6912,5370,12282,45,47,92,3,592
42,40,82,0,0,0,3,593
32,20,52,0,0,0,3,594
36,110,146,1,0,1,3,595
2,5,7,0,0,0,3,596
6,4,10,0,0,0,3,597
3,1,4,0,0,0,3,598
0,2,2,0,0,0,3,599
127,56,183,3,0,3,3,600
16,4,20,0,0,0,3,601
41,31,72,0,0,0,3,602
26,8,34,0,0,0,3,603
112,17,129,0,0,0,3,604
82,21,103,2,0,2,3,605
9,2,11,0,0,0,3,606
52,19,71,2,0,2,3,607
23,14,37,0,0,0,3,608
16,1,17,0,0,0,3,609
94,6,100,3,0,3,3,610
31,7,38,0,0,0,3,611
1,2,3,0,0,0,3,612
388,152,540,9,1,10,3,613
3,2,5,0,0,0,3,614
4,0,4,0,0,0,3,615
2,0,2,0,0,0,3,616
4,9,13,0,0,0,3,617
4,0,4,0,0,0,3,618
2,0,2,0,0,0,3,619
5,1,6,0,0,0,3,620
3,3,6,0,0,0,3,621
11,5,16,0,0,0,3,622
5,5,10,0,0,0,3,623
1,0,1,0,0,0,3,624
10,35,45,0,0,0,3,625
1,0,1,0,0,0,3,626
2,0,2,0,0,0,3,627
3,1,4,0,0,0,3,628
1,4,5,0,1,1,3,629
7,3,10,0,0,0,3,630
5,8,13,0,0,0,3,631
28,19,47,0,0,0,3,632
0,2,2,0,0,0,3,633
2,0,2,0,0,0,3,634
329,42,371,2,0,2,3,635
1,2,3,0,0,0,3,636
3,4,7,0,0,0,3,637
7,6,13,0,0,0,3,638
6,0,6,0,0,0,3,639
9,5,14,0,0,0,3,640
5,7,12,0,0,0,3,641
4,0,4,0,0,0,3,642
2,1,3,0,0,0,3,643
2,0,2,0,0,0,3,644
5,1,6,0,0,0,3,645
1,2,3,0,0,0,3,646
3,0,3,0,0,0,3,647
0,0,0,0,0,0,3,648
5,3,8,0,0,0,3,649
30,25,55,0,0,0,3,650
873,379,1252,6,1,7,3,651
6963,820,7783,41,3,44,3,652
516,560,1076,4,4,8,3,653
522,530,1052,6,7,13,3,654
20,4,24,0,0,0,3,655
0,0,0,0,0,0,3,656
5,4,9,0,0,0,3,657
5,3,8,0,0,0,3,658
61,123,184,0,3,3,3,659
1206,4643,5849,21,50,71,3,660
8,0,8,0,0,0,3,661
7,4,11,0,0,0,3,662
8,7,15,0,0,0,3,663
1,2,3,0,0,0,3,664
6,3,9,0,0,0,3,665
43,31,74,0,0,0,3,666
35,49,84,0,1,1,3,667
5,3,8,0,0,0,3,668
11,13,24,0,0,0,3,669
11,2,13,0,0,0,3,670
17,19,36,0,0,0,3,671
2,2,4,0,0,0,3,672
2,9,11,0,0,0,3,673
3,9,12,0,0,0,3,674
11,6,17,0,0,0,3,675
2,2,4,0,0,0,3,676
3,15,18,0,0,0,3,677
3,5,8,0,0,0,3,678
2,3,5,0,0,0,3,679
4,4,8,1,0,1,3,680
40,91,131,1,2,3,3,681
3,8,11,0,0,0,3,682
1,2,3,0,0,0,3,683
60,55,115,2,0,2,3,684
34,45,79,0,2,2,3,685
312,155,467,1,1,2,3,686
21,60,81,0,2,2,3,687
40,117,157,0,4,4,3,688
5,8,13,0,0,0,3,689
7,13,20,0,0,0,3,690
19,24,43,0,0,0,3,691
13,48,61,0,1,1,3,692
38,136,174,1,2,3,3,693
14,14,28,0,0,0,3,694
34,12,46,1,0,1,3,695
20,24,44,1,0,1,3,696
1,3,4,0,0,0,3,697
76,293,369,1,1,2,3,698
37,42,79,0,0,0,3,699
11,11,22,0,0,0,3,700
8,2,10,0,0,0,3,701
6,5,11,0,0,0,3,702
3,3,6,0,0,0,3,703
9,7,16,0,0,0,3,704
1,7,8,0,0,0,3,705
7,10,17,0,0,0,3,706
11,14,25,0,0,0,3,707
10,2,12,0,0,0,3,708
1,15,16,0,0,0,3,709
4,15,19,0,0,0,3,710
8,1,9,0,0,0,3,711
4,0,4,0,0,0,3,712
60,270,330,0,0,0,3,713
28,30,58,0,0,0,3,714
57,83,140,0,0,0,3,715
59,111,170,0,1,1,3,716
37,68,105,0,0,0,3,717
14,5,19,0,0,0,3,718
18,22,40,0,0,0,3,719
48,31,79,1,0,1,3,720
2,7,9,0,0,0,3,721
29,218,247,0,0,0,3,722
16,85,101,0,0,0,3,723
11,15,26,0,0,0,3,724
4,8,12,0,0,0,3,725
5,3,8,0,0,0,3,726
4,3,7,0,0,0,3,727
0,3,3,0,0,0,3,728
2,5,7,0,0,0,3,729
3,5,8,0,0,0,3,730
1,4,5,0,0,0,3,731
2,3,5,0,0,0,3,732
2,5,7,0,0,0,3,733
1,4,5,0,0,0,3,734
5,7,12,0,0,0,3,735
4,2,6,0,0,0,3,736
0,0,0,0,0,0,3,737
2,2,4,0,0,0,3,738
7,1,8,0,0,0,3,739
2,0,2,0,0,0,3,740
9,34,43,0,0,0,3,741
0,3,3,0,0,0,3,742
11,1,12,0,0,0,3,743
24,10,34,0,0,0,3,744
34,74,108,0,3,3,3,745
3,11,14,1,0,1,3,746
4,1,5,0,0,0,3,747
6,7,13,0,0,0,3,748
4,2,6,0,1,1,3,749
2,2,4,0,0,0,3,750
7,1,8,1,0,1,3,751
6,13,19,0,1,1,3,752
49,81,130,0,1,1,3,753
5,7,12,0,0,0,3,754
2,3,5,0,0,0,3,755
3,3,6,0,0,0,3,756
8,5,13,0,0,0,3,757
1,0,1,0,0,0,3,758
1,0,1,0,0,0,3,759
0,0,0,0,0,0,3,760
1,0,1,0,0,0,3,761
0,0,0,0,0,0,3,762
1,1,2,0,0,0,3,763
1,0,1,0,0,0,3,764
1,1,2,0,0,0,3,765
0,0,0,0,0,0,3,766
4,10,14,0,1,1,3,767
7,18,25,0,0,0,3,768
0,4,4,0,0,0,3,769
11,0,11,0,0,0,3,770
1,1,2,0,0,0,3,771
0,1,1,0,0,0,3,772
23,5,28,0,0,0,3,773
1557,395,1952,9,3,12,3,774
49,34,83,0,2,2,3,775
64,11,75,0,0,0,3,776
725,905,1630,15,26,41,3,777
98,936,1034,4,40,44,3,778
7,6,13,0,0,0,3,779
9,6,15,0,0,0,3,780
15,36,51,0,0,0,3,781
5,1,6,1,0,1,3,782
6,11,17,0,0,0,3,783
568,998,1566,4,2,6,3,784
183,57,240,0,1,1,3,785
383,609,992,1,4,5,3,786
21,46,67,0,0,0,3,787
248,885,1133,1,3,4,3,788
115,206,321,0,0,0,3,789
62,72,134,1,0,1,3,790
139,743,882,3,10,13,3,791
8,1,9,0,0,0,3,792
6,3,9,0,0,0,3,793
7,3,10,0,0,0,3,794
198,43,241,1,0,1,3,795
9,7,16,0,0,0,3,796
5,1,6,0,0,0,3,797
6,0,6,0,0,0,3,798
35,6,41,0,0,0,3,799
3,1,4,0,0,0,3,800
86,15,101,0,0,0,3,801
147,22,169,0,0,0,3,802
134,126,260,0,1,1,3,803
20,8,28,0,0,0,3,804
13,21,34,0,0,0,3,805
17,6,23,0,0,0,3,806
66,90,156,1,3,4,3,807
7,8,15,0,0,0,3,808
7,0,7,0,0,0,3,809
7,4,11,0,0,0,3,810
2,2,4,0,0,0,3,811
2,1,3,0,0,0,3,812
34,16,50,0,0,0,3,813
5,0,5,0,0,0,3,814
51,19,70,1,0,1,3,815
85,4,89,1,0,1,3,816
90,109,199,1,0,1,3,817
355,173,528,8,2,10,3,818
157,100,257,1,2,3,3,819
1923,1248,3171,32,12,44,3,820
35,23,58,1,0,1,3,821
1747,652,2399,25,5,30,3,822
30,52,82,0,0,0,3,823
620,246,866,7,4,11,3,824
1073,387,1460,5,1,6,3,825
767,595,1362,4,2,6,3,826
13,4,17,0,0,0,3,827
31,14,45,1,0,1,3,828
7,3,10,0,0,0,3,829
15,21,36,0,0,0,3,830
4,1,5,0,0,0,3,831
37,10,47,0,0,0,3,832
4,4,8,0,0,0,3,833
31,7,38,0,0,0,3,834
4,2,6,0,0,0,3,835
91,119,210,0,2,2,3,836
8,3,11,0,0,0,3,837
21,17,38,0,0,0,3,838
8,3,11,0,0,0,3,839
4,4,8,0,0,0,3,840
36,21,57,0,1,1,3,841
50,57,107,0,0,0,3,842
20,43,63,0,0,0,3,843
2,9,11,0,0,0,3,844
8,5,13,0,0,0,3,845
23,5,28,0,0,0,3,846
3,1,4,0,0,0,3,847
6,1,7,0,0,0,3,848
14,9,23,0,0,0,3,849
277,267,544,4,6,10,3,850
450,394,844,11,5,16,3,851
4,6,10,0,1,1,3,852
37,28,65,0,2,2,3,853
7,20,27,0,0,0,3,854
7,15,22,1,0,1,3,855
13,21,34,0,0,0,3,856
33,9,42,0,0,0,3,857
14,5,19,0,0,0,3,858
9,20,29,0,0,0,3,859
10,5,15,1,0,1,3,860
16,5,21,0,0,0,3,861
48,40,88,0,0,0,3,862
7,45,52,0,0,0,3,863
14,7,21,0,0,0,3,864
23,112,135,0,4,4,3,865
29,11,40,0,0,0,3,866
4,8,12,0,0,0,3,867
8,0,8,0,0,0,3,868
11,3,14,0,0,0,3,869
63,5,68,2,0,2,3,870
1297,210,1507,34,2,36,3,871
126,68,194,0,0,0,3,872
50,19,69,0,1,1,3,873
34,21,55,0,0,0,3,874
6,4,10,0,0,0,3,875
164,83,247,1,0,1,3,876
157,68,225,0,0,0,3,877
133,77,210,2,1,3,3,878
13,6,19,0,0,0,3,879
8,9,17,0,0,0,3,880
76,7,83,0,0,0,3,881
10,34,44,0,0,0,3,882
7,8,15,0,0,0,3,883
10,6,16,0,0,0,3,884
4,10,14,0,0,0,3,885
10,5,15,0,0,0,3,886
11,5,16,0,0,0,3,887
14,4,18,0,0,0,3,888
17,20,37,0,0,0,3,889
7,3,10,0,0,0,3,890
22,15,37,0,1,1,3,891
1,0,1,0,0,0,3,892
14,12,26,0,0,0,3,893
8,3,11,0,0,0,3,894
99,36,135,1,0,1,3,895
30,28,58,2,0,2,3,896
5,0,5,0,0,0,3,897
2,0,2,0,0,0,3,898
0,1,1,0,0,0,3,899
1,3,4,0,0,0,3,900
3,3,6,0,0,0,3,901
2,2,4,0,0,0,3,902
12,10,22,0,0,0,3,903
10,13,23,0,0,0,3,904
10,16,26,0,1,1,3,905
24,8,32,0,0,0,3,906
2,4,6,0,0,0,3,907
7,4,11,0,0,0,3,908
4,0,4,0,0,0,3,909
3,3,6,0,0,0,3,910
4,1,5,0,0,0,3,911
3,5,8,0,0,0,3,912
37,8,45,0,0,0,3,913
12,15,27,0,2,2,3,914
4,18,22,0,1,1,3,915
3,4,7,0,0,0,3,916
0,4,4,0,0,0,3,917
2,5,7,0,0,0,3,918
29,123,152,0,0,0,3,919
21,14,35,0,0,0,3,920
18,4,22,0,0,0,3,921
0,1,1,0,0,0,3,922
5,8,13,0,1,1,3,923
2,1,3,0,0,0,3,924
6,15,21,0,1,1,3,925
1,0,1,0,0,0,3,926
0,3,3,0,0,0,3,927
1,3,4,0,0,0,3,928
5,13,18,0,0,0,3,929
4,1,5,0,0,0,3,930
0,1,1,0,0,0,3,931
2,3,5,0,0,0,3,932
0,2,2,0,0,0,3,933
1,2,3,0,0,0,3,934
0,3,3,0,0,0,3,935
0,0,0,0,0,0,3,936
1,2,3,0,0,0,3,937
4,11,15,0,0,0,3,938
0,1,1,0,0,0,3,939
2,4,6,0,0,0,3,940
10,6,16,1,0,1,3,941
2,2,4,0,0,0,3,942
16,27,43,0,0,0,3,943
2,1,3,0,0,0,3,944
24,48,72,0,0,0,3,945
3,4,7,0,0,0,3,946
1,3,4,0,0,0,3,947
41,46,87,0,0,0,3,948
1,1,2,0,0,0,3,949
3,0,3,0,0,0,3,950
2348,916,3264,7,4,11,3,951
346,128,474,1,1,2,3,952
2,0,2,0,0,0,3,953
8,2,10,0,0,0,3,954
12,5,17,0,0,0,3,955
49,21,70,1,0,1,3,956
38,99,137,0,0,0,3,957
1,1,2,0,0,0,3,958
286,550,836,1,2,3,3,959
5,1,6,0,0,0,3,960
2,4,6,0,0,0,3,961
4,1,5,0,0,0,3,962
14,5,19,0,0,0,3,963
14,3,17,0,0,0,3,964
2,0,2,0,0,0,3,965
5,4,9,0,0,0,3,966
7,4,11,0,0,0,3,967
5,4,9,0,0,0,3,968
2,2,4,0,0,0,3,969
3,0,3,0,0,0,3,970
6,1,7,0,0,0,3,971
2,1,3,0,0,0,3,972
26,13,39,0,0,0,3,973
2,7,9,0,0,0,3,974
17,5,22,0,0,0,3,975
10,3,13,0,0,0,3,976
11,6,17,1,0,1,3,977
18,23,41,1,0,1,3,978
59,16,75,1,0,1,3,979
25,5,30,1,0,1,3,980
3,6,9,0,0,0,3,981
6,1,7,0,0,0,3,982
7,11,18,0,0,0,3,983
299,42,341,6,0,6,3,984
14,2,16,1,0,1,3,985
36,12,48,0,0,0,3,986
22,7,29,0,0,0,3,987
27,12,39,0,0,0,3,988
8,4,12,0,0,0,3,989
2,1,3,0,0,0,3,990
17,7,24,1,0,1,3,991
9,0,9,0,0,0,3,992
5,1,6,0,0,0,3,993
7,3,10,0,0,0,3,994
6,2,8,0,0,0,3,995
1327,1555,2882,8,11,19,3,996
0,0,0,0,0,0,3,997
46,76,122,0,0,0,3,998
23,41,64,0,0,0,3,999
12,14,26,0,0,0,3,1000
1,5,6,0,0,0,3,1001
7,5,12,0,0,0,3,1002
17,3,20,0,0,0,3,1003
4,5,9,0,0,0,3,1004
0,0,0,0,0,0,3,1005
828,494,1322,7,5,12,3,1006
72,195,267,2,0,2,3,1007
5,1,6,0,0,0,3,1008
6,5,11,0,0,0,3,1009
5,2,7,0,0,0,3,1010
6,1,7,0,0,0,3,1011
18,6,24,0,0,0,3,1012
5,10,15,0,0,0,3,1013
1,8,9,0,0,0,3,1014
3,2,5,0,0,0,3,1015
36,51,87,0,5,5,3,1016
0,0,0,0,0,0,3,1017
5,0,5,0,0,0,3,1018
1,3,4,0,0,0,3,1019
2,0,2,0,0,0,3,1020
1,0,1,0,0,0,3,1021
0,0,0,0,0,0,3,1022
1,1,2,0,0,0,3,1023
1,0,1,0,0,0,3,1024
0,2,2,0,0,0,3,1025
0,1,1,0,0,0,3,1026
169,219,388,2,6,8,3,1027
4,9,13,0,0,0,3,1028
0,1,1,0,0,0,3,1029
3,0,3,0,0,0,3,1030
5,1,6,0,0,0,3,1031
6,0,6,0,0,0,3,1032
5,6,11,1,0,1,3,1033
1,1,2,0,0,0,3,1034
2,2,4,0,0,0,3,1035
0,2,2,0,0,0,3,1036
2,0,2,0,0,0,3,1037
13,1,14,1,0,1,3,1038
3,8,11,0,1,1,3,1039
33,87,120,0,0,0,3,1040
160,583,743,3,11,14,3,1041
6,1,7,0,0,0,3,1042
8,10,18,0,0,0,3,1043
3,5,8,0,0,0,3,1044
14,6,20,0,0,0,3,1045
7,3,10,0,0,0,3,1046
132,150,282,4,1,5,3,1047
59,281,340,0,0,0,3,1048
55,27,82,0,0,0,3,1049
2,1,3,0,0,0,3,1050
23,17,40,0,0,0,3,1051
170,294,464,1,2,3,3,1052
11,11,22,0,0,0,3,1053
10,14,24,0,0,0,3,1054
15,2,17,0,0,0,3,1055
1,0,1,0,0,0,3,1056
13,7,20,0,0,0,3,1057
229,267,496,2,1,3,3,1058
368,240,608,6,1,7,3,1059
6,2,8,0,0,0,3,1060
65,186,251,1,4,5,3,1061
5,13,18,0,0,0,3,1062
3,16,19,0,0,0,3,1063
1190,1749,2939,16,19,35,3,1064
139,786,925,1,27,28,3,1065
199,647,846,2,5,7,3,1066
80,255,335,2,3,5,3,1067
32,65,97,1,2,3,3,1068
11,10,21,0,0,0,3,1069
0,0,0,0,0,0,3,1070
21,16,37,1,0,1,3,1071
185,250,435,1,2,3,3,1072
2,4,6,0,0,0,3,1073
0,2,2,0,0,0,3,1074
1,2,3,0,0,0,3,1075
7,0,7,0,0,0,3,1076
3,3,6,0,0,0,3,1077
2,23,25,0,0,0,3,1078
8,7,15,0,0,0,3,1079
15,15,30,0,0,0,3,1080
2,4,6,0,0,0,3,1081
23,9,32,0,0,0,3,1082
8,11,19,1,1,2,3,1083
1724,1236,2960,15,9,24,3,1084
18,4,22,0,0,0,3,1085
7,4,11,0,0,0,3,1086
41,27,68,1,0,1,3,1087
7,4,11,0,0,0,3,1088
22,22,44,0,0,0,3,1089
33,76,109,0,0,0,3,1090
0,1,1,0,0,0,3,1091
57,30,87,1,0,1,3,1092
248,104,352,5,3,8,3,1093
81,12,93,0,0,0,3,1094
23,10,33,0,0,0,3,1095
29,13,42,0,1,1,3,1096
38,18,56,1,0,1,3,1097
67,41,108,0,0,0,3,1098
1700,1214,2914,6,7,13,3,1099
13,17,30,0,0,0,3,1100
49,20,69,0,0,0,3,1101
26,3,29,0,0,0,3,1102
62,32,94,1,0,1,3,1103
5,14,19,0,0,0,3,1104
14,6,20,0,0,0,3,1105
13,3,16,0,0,0,3,1106
3,2,5,0,0,0,3,1107
2,1,3,0,0,0,3,1108
4,6,10,0,0,0,3,1109
5,2,7,0,0,0,3,1110
3,0,3,0,0,0,3,1111
22,1,23,0,0,0,3,1112
19,1,20,0,0,0,3,1113
8,5,13,0,0,0,3,1114
8,6,14,0,0,0,3,1115
5,19,24,0,0,0,3,1116
15,8,23,0,0,0,3,1117
15,12,27,0,1,1,3,1118
378,1195,1573,5,34,39,3,1119
164,982,1146,1,19,20,3,1120
73,206,279,0,0,0,3,1121
1363,253,1616,3,0,3,3,1122
18,4,22,0,0,0,3,1123
476,1276,1752,10,11,21,3,1124
43,80,123,0,1,1,3,1125
4,5,9,0,2,2,3,1126
1,8,9,0,0,0,3,1127
7,25,32,0,0,0,3,1128
0,2,2,0,0,0,3,1129
2,1,3,0,0,0,3,1130
1,2,3,0,0,0,3,1131
2,0,2,0,0,0,3,1132
642,929,1571,1,1,2,3,1133
2,0,2,0,0,0,3,1134
4,5,9,0,0,0,3,1135
29,49,78,1,4,5,3,1136
169,269,438,0,1,1,3,1137
10,3,13,0,0,0,3,1138
15,0,15,0,0,0,3,1139
8,10,18,0,0,0,3,1140
0,2,2,0,0,0,3,1141
8,11,19,0,0,0,3,1142
10,31,41,0,0,0,3,1143
0,0,0,-22,-4,-26,3,1144
4,6,10,0,0,0,3,1145
4091,3250,7341,64,49,113,3,1146
152,8,160,0,0,0,3,1147
13,6,19,0,0,0,3,1148
43,28,71,0,0,0,3,1149
40,17,57,0,0,0,3,1150
0,0,0,-54,-192,-246,3,1151
231,595,826,2,4,6,3,1152
56,179,235,0,1,1,3,1153
28,10,38,0,0,0,3,1154
12,13,25,0,0,0,3,1155
50,67,117,0,2,2,3,1156
15,10,25,0,0,0,3,1157
11,2,13,0,0,0,3,1158
27,9,36,1,1,2,3,1159
44,37,81,1,0,1,3,1160
42,85,127,0,0,0,3,1161
195,307,502,0,0,0,3,1162
41,91,132,0,0,0,3,1163
39,42,81,0,0,0,3,1164
8,1,9,0,0,0,3,1165
2188,3530,5718,8,13,21,3,1166
292,228,520,0,1,1,3,1167
9,22,31,0,0,0,3,1168
184,153,337,1,0,1,3,1169
12128,5680,17808,53,33,86,3,1170
30,24,54,0,0,0,3,1171
195,55,250,1,0,1,3,1172
28,5,33,0,0,0,3,1173
7,5,12,0,0,0,3,1174
1287,352,1639,11,1,12,3,1175
214,164,378,1,2,3,3,1176
275,427,702,1,1,2,3,1177
67,7,74,0,0,0,3,1178
635606,180853,816459,733,267,1000,3,1179
262,103,365,0,2,2,3,1180
118,52,170,0,0,0,3,1181
73,37,110,1,3,4,3,1182
664,222,886,5,1,6,3,1183
122,93,215,1,2,3,3,1184
0,0,0,0,0,0,3,1185
77,130,207,0,0,0,3,1186
260,388,648,6,7,13,3,1187
251,363,614,2,5,7,3,1188
218,73,291,3,1,4,3,1189
10,6,16,0,0,0,3,1190
54,16,70,0,0,0,3,1191
1072,1928,3000,8,12,20,3,1192
0,0,0,0,0,0,3,1193
145,863,1008,1,6,7,3,1194
1022,1334,2356,3,8,11,3,1195
0,0,0,0,0,0,3,1196
980,1110,2090,11,11,22,3,1197
2677,5290,7967,38,77,115,3,1198
76,124,200,0,0,0,3,1199
117,184,301,2,4,6,3,1200
2354,1723,4077,40,32,72,3,1201
3,4,7,0,0,0,3,1202
8,4,12,0,0,0,3,1203
1,2,3,0,0,0,3,1204
0,0,0,0,0,0,3,1205
1516,1449,2965,13,16,29,3,1206
7,24,31,0,0,0,3,1207
91,31,122,0,0,0,3,1208
132,43,175,0,0,0,3,1209
0,0,0,0,0,0,3,1210
0,0,0,0,0,0,3,1211
240,53,293,0,1,1,3,1212
114,16,130,1,0,1,3,1213
1548,1940,3488,11,18,29,3,1214
13,14,27,0,1,1,3,1215
163,66,229,0,0,0,3,1216
14,5,19,0,0,0,3,1217
8,4,12,0,1,1,3,1218
5,1,6,0,0,0,3,1219
2,0,2,0,0,0,3,1220
0,0,0,0,0,0,3,1221
2,4,6,0,0,0,3,1222
0,0,0,0,0,0,3,1223
0,0,0,0,0,0,3,1224
0,0,0,0,0,0,3,1225
1,4,5,0,0,0,3,1226
2,0,2,0,0,0,3,1227
8,8,16,0,1,1,3,1228
6,1,7,0,0,0,3,1229
1,2,3,1,1,2,3,1230
0,0,0,0,0,0,3,1231
0,1,1,0,0,0,3,1232
17,14,31,0,0,0,3,1233
1,1,2,0,0,0,3,1234
0,1,1,0,0,0,3,1235
1,2,3,0,0,0,3,1236
1,0,1,0,0,0,3,1237
19,19,38,0,0,0,3,1238
4,1,5,0,0,0,3,1239
8,6,14,0,0,0,3,1240
8,5,13,0,1,1,3,1241
0,0,0,0,0,0,3,1242
3,1,4,1,0,1,3,1243
2,1,3,0,0,0,3,1244
4,6,10,0,0,0,3,1245
0,0,0,0,0,0,3,1246
1,1,2,0,0,0,3,1247
36,33,69,0,0,0,3,1248
5,1,6,0,1,1,3,1249
2,2,4,0,1,1,3,1250
1,0,1,0,0,0,3,1251
2,1,3,0,0,0,3,1252
5,0,5,0,0,0,3,1253
0,0,0,0,0,0,3,1254
39,46,85,0,0,0,3,1255
1,0,1,0,0,0,3,1256
2,1,3,0,0,0,3,1257
0,0,0,0,0,0,3,1258
1,0,1,0,0,0,3,1259
7,7,14,0,0,0,3,1260
33,12,45,0,0,0,3,1261
1,0,1,0,0,0,3,1262
12,4,16,1,0,1,3,1263
0,0,0,0,0,0,3,1264
1,0,1,0,0,0,3,1265
2,0,2,0,0,0,3,1266
6,4,10,1,0,1,3,1267
6,10,16,0,0,0,3,1268
5,0,5,0,0,0,3,1269
0,0,0,0,0,0,3,1270
6,0,6,0,0,0,3,1271
2,0,2,0,0,0,3,1272
13,13,26,0,0,0,3,1273
1,0,1,0,0,0,3,1274
1,1,2,0,0,0,3,1275
1,2,3,0,0,0,3,1276
4,1,5,0,0,0,3,1277
0,0,0,0,0,0,3,1278
1,1,2,0,0,0,3,1279
1,0,1,0,0,0,3,1280
0,0,0,0,0,0,3,1281
0,5,5,0,0,0,3,1282
8,3,11,0,0,0,3,1283
4,1,5,0,1,1,3,1284
0,1,1,0,0,0,3,1285
0,1,1,0,0,0,3,1286
0,0,0,0,0,0,3,1287
0,0,0,-3,-2,-5,3,1288
3,0,3,0,0,0,3,1289
15,18,33,0,0,0,3,1290
0,2,2,0,0,0,3,1291
3,1,4,0,0,0,3,1292
4,2,6,0,0,0,3,1293
1,0,1,0,0,0,3,1294
2,4,6,0,1,1,3,1295
3,2,5,0,0,0,3,1296
0,0,0,0,0,0,3,1297
3,1,4,0,0,0,3,1298
13,4,17,0,0,0,3,1299
0,0,0,0,0,0,3,1300
0,0,0,0,0,0,3,1301
5,9,14,0,0,0,3,1302
3,3,6,0,0,0,3,1303
3,2,5,0,0,0,3,1304
5,1,6,0,1,1,3,1305
0,1,1,0,0,0,3,1306
3,5,8,1,1,2,3,1307
2,2,4,0,0,0,3,1308
5,4,9,0,0,0,3,1309
3,4,7,0,0,0,3,1310
0,2,2,0,0,0,3,1311
0,10,10,0,0,0,3,1312
2,0,2,1,0,1,3,1313
1,0,1,0,0,0,3,1314
0,1,1,0,1,1,3,1315
1,1,2,0,1,1,3,1316
0,0,0,0,0,0,3,1317
4,4,8,0,0,0,3,1318
6,2,8,0,0,0,3,1319
0,0,0,0,0,0,3,1320
2,0,2,0,0,0,3,1321
0,1,1,0,0,0,3,1322
0,0,0,0,0,0,3,1323
5,0,5,0,0,0,3,1324
0,2,2,0,0,0,3,1325
1,1,2,0,0,0,3,1326
7,0,7,0,0,0,3,1327
8,4,12,0,0,0,3,1328
1,0,1,0,0,0,3,1329
1,0,1,0,0,0,3,1330
4,2,6,0,0,0,3,1331
2,0,2,0,0,0,3,1332
1,0,1,0,0,0,3,1333
2,0,2,0,0,0,3,1334
2,1,3,0,0,0,3,1335
2,1,3,0,0,0,3,1336
4,6,10,0,0,0,3,1337
2,3,5,0,0,0,3,1338
1,1,2,0,0,0,3,1339
3,5,8,0,0,0,3,1340
8,0,8,0,0,0,3,1341
1,0,1,0,0,0,3,1342
0,1,1,0,0,0,3,1343
2,2,4,0,0,0,3,1344
2,0,2,0,0,0,3,1345
0,0,0,0,0,0,3,1346
0,0,0,0,0,0,3,1347
0,3,3,0,0,0,3,1348
1,4,5,0,0,0,3,1349
3,3,6,0,0,0,3,1350
4,6,10,0,0,0,3,1351
0,0,0,0,0,0,3,1352
0,0,0,0,0,0,3,1353
5,2,7,0,0,0,3,1354
0,0,0,0,0,0,3,1355
1,1,2,0,0,0,3,1356
0,1,1,0,0,0,3,1357
2,3,5,0,1,1,3,1358
4,0,4,0,0,0,3,1359
5,3,8,0,0,0,3,1360
22,23,45,0,0,0,3,1361
1,2,3,0,0,0,3,1362
4,4,8,0,0,0,3,1363
1,1,2,0,0,0,3,1364
0,0,0,0,0,0,3,1365
2,1,3,0,0,0,3,1366
3,3,6,0,0,0,3,1367
0,1,1,0,0,0,3,1368
2,1,3,0,0,0,3,1369
0,0,0,0,0,0,3,1370
5,0,5,0,0,0,3,1371
1,0,1,0,0,0,3,1372
2,0,2,0,0,0,3,1373
6,6,12,0,0,0,3,1374
1,1,2,0,0,0,3,1375
1,0,1,0,0,0,3,1376
1,0,1,0,0,0,3,1377
0,0,0,0,0,0,3,1378
0,0,0,0,0,0,3,1379
0,0,0,0,0,0,3,1380
0,1,1,0,1,1,3,1381
4,0,4,0,0,0,3,1382
36,26,62,0,0,0,3,1383
2,2,4,0,0,0,3,1384
4,0,4,0,0,0,3,1385
3,2,5,0,0,0,3,1386
4,0,4,0,0,0,3,1387
2,4,6,0,0,0,3,1388
3,4,7,0,0,0,3,1389
2,0,2,0,0,0,3,1390
5,3,8,0,0,0,3,1391
2,0,2,0,0,0,3,1392
3,1,4,0,0,0,3,1393
1,1,2,0,0,0,3,1394
23,91,114,0,0,0,3,1395
2,0,2,0,0,0,3,1396
2,2,4,0,0,0,3,1397
1,0,1,1,0,1,3,1398
5,5,10,0,0,0,3,1399
2,0,2,0,0,0,3,1400
4,1,5,0,0,0,3,1401
3,0,3,0,0,0,3,1402
13,8,21,1,0,1,3,1403
1,3,4,0,0,0,3,1404
2,7,9,0,0,0,3,1405
4,0,4,0,0,0,3,1406
3,3,6,0,0,0,3,1407
6,0,6,0,0,0,3,1408
1,2,3,0,0,0,3,1409
1,0,1,0,0,0,3,1410
6,1,7,0,0,0,3,1411
6,3,9,0,0,0,3,1412
2,4,6,0,0,0,3,1413
2,6,8,0,0,0,3,1414
3,0,3,0,0,0,3,1415
4,5,9,0,0,0,3,1416
1,0,1,0,0,0,3,1417
5,21,26,0,0,0,3,1418
9,2,11,0,0,0,3,1419
6,5,11,0,0,0,3,1420
3,5,8,0,0,0,3,1421
1,0,1,0,0,0,3,1422
1,2,3,0,0,0,3,1423
22,11,33,0,0,0,3,1424
5,14,19,0,0,0,3,1425
140,166,306,1,0,1,3,1426
1,1,2,0,0,0,3,1427
1,1,2,0,0,0,3,1428
0,0,0,0,0,0,3,1429
0,0,0,-5,-1,-6,3,1430
1,0,1,0,0,0,3,1431
0,1,1,0,0,0,3,1432
1,5,6,0,0,0,3,1433
2,0,2,0,0,0,3,1434
0,1,1,0,0,0,3,1435
5,2,7,0,0,0,3,1436
0,5,5,0,0,0,3,1437
3,2,5,0,0,0,3,1438
3,2,5,0,0,0,3,1439
3,0,3,0,0,0,3,1440
7,0,7,0,0,0,3,1441
2,2,4,0,0,0,3,1442
2,3,5,0,0,0,3,1443
4,0,4,0,0,0,3,1444
2,3,5,0,0,0,3,1445
0,1,1,0,0,0,3,1446
1,2,3,0,0,0,3,1447
0,0,0,0,0,0,3,1448
5,1,6,0,0,0,3,1449
0,1,1,0,0,0,3,1450
3,2,5,0,0,0,3,1451
0,0,0,0,0,0,3,1452
1,1,2,0,1,1,3,1453
3,1,4,0,0,0,3,1454
24,13,37,1,0,1,3,1455
3,3,6,0,0,0,3,1456
2,0,2,0,0,0,3,1457
2,0,2,0,0,0,3,1458
0,2,2,0,0,0,3,1459
1,2,3,0,0,0,3,1460
0,0,0,0,0,0,3,1461
4,1,5,0,0,0,3,1462
23,18,41,0,0,0,3,1463
0,1,1,0,0,0,3,1464
1,1,2,0,0,0,3,1465
4,1,5,0,0,0,3,1466
0,0,0,0,0,0,3,1467
4,0,4,0,0,0,3,1468
5,2,7,0,0,0,3,1469
5,1,6,0,0,0,3,1470
1,0,1,0,0,0,3,1471
2,2,4,0,0,0,3,1472
2,0,2,0,0,0,3,1473
2,4,6,0,0,0,3,1474
2,5,7,0,0,0,3,1475
46,5,51,0,0,0,3,1476
3,2,5,0,1,1,3,1477
2,4,6,0,0,0,3,1478
1,3,4,0,0,0,3,1479
1,0,1,0,0,0,3,1480
1,0,1,0,0,0,3,1481
3,2,5,0,0,0,3,1482
14,19,33,0,1,1,3,1483
10,1,11,1,0,1,3,1484
5,1,6,0,0,0,3,1485
1,3,4,0,0,0,3,1486
199,117,316,4,1,5,3,1487
1,0,1,0,0,0,3,1488
0,0,0,0,0,0,3,1489
3,0,3,0,0,0,3,1490
1,0,1,0,0,0,3,1491
4,1,5,0,0,0,3,1492
4,1,5,0,0,0,3,1493
2,4,6,0,0,0,3,1494
0,0,0,0,0,0,3,1495
9,2,11,0,0,0,3,1496
1,1,2,0,0,0,3,1497
4,1,5,0,1,1,3,1498
2,0,2,0,0,0,3,1499
23,3,26,0,0,0,3,1500
6,0,6,0,0,0,3,1501
4,0,4,0,0,0,3,1502
5,1,6,0,0,0,3,1503
4,0,4,0,0,0,3,1504
9,1,10,0,0,0,3,1505
1,0,1,0,0,0,3,1506
4,1,5,0,0,0,3,1507
11,2,13,0,0,0,3,1508
2,1,3,0,0,0,3,1509
2,0,2,0,0,0,3,1510
0,1,1,0,0,0,3,1511
5,7,12,0,0,0,3,1512
2,5,7,0,0,0,3,1513
0,0,0,0,0,0,3,1514
22,7,29,0,0,0,3,1515
0,0,0,0,0,0,3,1516
18,5,23,0,0,0,3,1517
1,0,1,0,0,0,3,1518
45,22,67,0,0,0,3,1519
2,1,3,0,0,0,3,1520
0,0,0,0,0,0,3,1521
3,5,8,0,0,0,3,1522
3,8,11,0,0,0,3,1523
0,0,0,0,0,0,3,1524
3,0,3,0,0,0,3,1525
2,0,2,0,0,0,3,1526
0,1,1,0,0,0,3,1527
5,8,13,0,0,0,3,1528
3,2,5,0,0,0,3,1529
0,0,0,0,0,0,3,1530
2,1,3,0,0,0,3,1531
5,1,6,0,0,0,3,1532
2,2,4,0,0,0,3,1533
2,0,2,0,0,0,3,1534
0,0,0,0,0,0,3,1535
0,0,0,0,0,0,3,1536
0,1,1,0,0,0,3,1537
2,2,4,0,0,0,3,1538
0,0,0,0,0,0,3,1539
3,2,5,0,0,0,3,1540
0,2,2,0,0,0,3,1541
2,3,5,0,0,0,3,1542
1,1,2,0,0,0,3,1543
1,1,2,0,0,0,3,1544
0,1,1,0,0,0,3,1545
1,1,2,0,0,0,3,1546
3,0,3,0,0,0,3,1547
2,0,2,0,0,0,3,1548
6,1,7,0,0,0,3,1549
25,12,37,0,0,0,3,1550
13,4,17,0,0,0,3,1551
1,0,1,0,0,0,3,1552
3,5,8,0,0,0,3,1553
1,1,2,0,0,0,3,1554
0,0,0,0,0,0,3,1555
3,1,4,0,0,0,3,1556
5,1,6,0,0,0,3,1557
1,0,1,0,0,0,3,1558
2,0,2,0,0,0,3,1559
2,1,3,0,0,0,3,1560
7,1,8,0,1,1,3,1561
2,0,2,0,0,0,3,1562
0,2,2,0,0,0,3,1563
2,0,2,0,0,0,3,1564
2,3,5,0,0,0,3,1565
6,8,14,0,0,0,3,1566
0,0,0,0,0,0,3,1567
6,1,7,0,0,0,3,1568
0,4,4,0,0,0,3,1569
0,2,2,0,0,0,3,1570
4,5,9,0,0,0,3,1571
38,34,72,0,0,0,3,1572
21,12,33,2,0,2,3,1573
7,1,8,0,0,0,3,1574
1,2,3,0,0,0,3,1575
4,4,8,0,0,0,3,1576
0,0,0,0,0,0,3,1577
1,1,2,0,0,0,3,1578
5,1,6,0,0,0,3,1579
0,0,0,0,0,0,3,1580
2,4,6,0,0,0,3,1581
0,2,2,0,0,0,3,1582
2,4,6,0,0,0,3,1583
5,6,11,0,0,0,3,1584
0,0,0,0,0,0,3,1585
1,2,3,0,0,0,3,1586
4,7,11,0,0,0,3,1587
0,1,1,0,0,0,3,1588
1,0,1,0,0,0,3,1589
0,0,0,0,0,0,3,1590
2,0,2,0,0,0,3,1591
1,0,1,0,0,0,3,1592
1,0,1,0,0,0,3,1593
2,5,7,0,0,0,3,1594
1,0,1,0,0,0,3,1595
1,7,8,0,0,0,3,1596
6,1,7,0,0,0,3,1597
3,0,3,1,0,1,3,1598
7,1,8,0,0,0,3,1599
283,89,372,0,0,0,3,1600
19,11,30,0,0,0,3,1601
37,26,63,2,1,3,3,1602
6,0,6,0,0,0,3,1603
2,0,2,1,0,1,3,1604
6,2,8,0,0,0,3,1605
2,0,2,0,0,0,3,1606
8,1,9,0,0,0,3,1607
1,4,5,0,0,0,3,1608
0,0,0,0,0,0,3,1609
2,0,2,0,0,0,3,1610
0,0,0,0,0,0,3,1611
0,0,0,0,0,0,3,1612
1,0,1,0,0,0,3,1613
6,0,6,0,0,0,3,1614
2,0,2,0,0,0,3,1615
0,0,0,0,0,0,3,1616
4,0,4,0,0,0,3,1617
4,13,17,0,0,0,3,1618
3,2,5,0,0,0,3,1619
4,3,7,0,0,0,3,1620
3,1,4,0,0,0,3,1621
1,0,1,0,0,0,3,1622
2,2,4,0,0,0,3,1623
0,0,0,0,0,0,3,1624
2,2,4,0,0,0,3,1625
4,2,6,0,0,0,3,1626
3,0,3,0,0,0,3,1627
1,7,8,0,0,0,3,1628
2,1,3,0,0,0,3,1629
2,3,5,0,0,0,3,1630
2,0,2,0,0,0,3,1631
2,0,2,0,0,0,3,1632
4,0,4,0,0,0,3,1633
3,0,3,0,0,0,3,1634
0,0,0,0,0,0,3,1635
4,3,7,0,0,0,3,1636
3,1,4,0,0,0,3,1637
1,1,2,0,0,0,3,1638
4,1,5,0,0,0,3,1639
0,0,0,0,0,0,3,1640
2,2,4,0,0,0,3,1641
0,2,2,0,0,0,3,1642
2,1,3,0,0,0,3,1643
0,0,0,0,0,0,3,1644
9,5,14,0,0,0,3,1645
0,0,0,0,0,0,3,1646
0,2,2,0,0,0,3,1647
0,0,0,0,0,0,3,1648
4,3,7,0,0,0,3,1649
8,1,9,0,0,0,3,1650
17,7,24,0,0,0,3,1651
7,2,9,0,0,0,3,1652
1,1,2,0,0,0,3,1653
1,0,1,0,0,0,3,1654
1,1,2,0,0,0,3,1655
1,0,1,0,0,0,3,1656
3,2,5,0,0,0,3,1657
0,0,0,0,0,0,3,1658
7,2,9,0,0,0,3,1659
1,2,3,0,0,0,3,1660
1,0,1,0,0,0,3,1661
2,0,2,0,0,0,3,1662
0,0,0,0,0,0,3,1663
2,0,2,0,0,0,3,1664
7,8,15,1,0,1,3,1665
2,0,2,1,0,1,3,1666
0,0,0,0,0,0,3,1667
4,1,5,0,0,0,3,1668
6,2,8,0,0,0,3,1669
6,2,8,0,0,0,3,1670
1,0,1,0,0,0,3,1671
0,0,0,0,0,0,3,1672
5,2,7,0,0,0,3,1673
5,2,7,0,0,0,3,1674
13,5,18,0,0,0,3,1675
1,0,1,0,0,0,3,1676
5,7,12,0,0,0,3,1677
2,0,2,0,0,0,3,1678
8,3,11,0,0,0,3,1679
0,0,0,0,0,0,3,1680
2,2,4,0,0,0,3,1681
1,2,3,0,0,0,3,1682
0,4,4,0,0,0,3,1683
53,84,137,0,0,0,3,1684
15,77,92,0,0,0,3,1685
1,2,3,0,0,0,3,1686
0,2,2,0,0,0,3,1687
62,49,111,0,0,0,3,1688
1,1,2,0,0,0,3,1689
0,1,1,0,0,0,3,1690
0,0,0,0,0,0,3,1691
9,3,12,0,0,0,3,1692
1,2,3,0,0,0,3,1693
1,2,3,0,0,0,3,1694
70,98,168,0,0,0,3,1695
0,0,0,0,0,0,3,1696
1,0,1,0,0,0,3,1697
2,0,2,0,0,0,3,1698
0,2,2,0,0,0,3,1699
7,11,18,0,0,0,3,1700
1,1,2,0,0,0,3,1701
0,4,4,0,0,0,3,1702
1,1,2,0,0,0,3,1703
121,65,186,0,0,0,3,1704
5,4,9,0,0,0,3,1705
3,2,5,0,0,0,3,1706
0,0,0,0,0,0,3,1707
17,16,33,1,0,1,3,1708
3,5,8,0,0,0,3,1709
0,2,2,0,0,0,3,1710
9,2,11,2,0,2,3,1711
2,1,3,0,0,0,3,1712
2,0,2,0,0,0,3,1713
2,0,2,0,0,0,3,1714
3,0,3,0,0,0,3,1715
74,36,110,0,0,0,3,1716
0,0,0,0,0,0,3,1717
0,1,1,0,0,0,3,1718
0,2,2,0,0,0,3,1719
7,2,9,0,0,0,3,1720
2,1,3,0,0,0,3,1721
10,21,31,0,0,0,3,1722
0,0,0,0,0,0,3,1723
6,1,7,2,0,2,3,1724
2,1,3,0,0,0,3,1725
3,2,5,0,0,0,3,1726
6,2,8,0,0,0,3,1727
33,8,41,0,0,0,3,1728
2,3,5,0,0,0,3,1729
0,0,0,0,0,0,3,1730
1,1,2,0,0,0,3,1731
0,0,0,0,0,0,3,1732
1,1,2,0,0,0,3,1733
2,0,2,0,0,0,3,1734
1,0,1,0,0,0,3,1735
2,2,4,0,0,0,3,1736
2,0,2,0,0,0,3,1737
4,3,7,0,0,0,3,1738
2,1,3,0,0,0,3,1739
0,1,1,0,0,0,3,1740
7,2,9,0,0,0,3,1741
6,2,8,0,0,0,3,1742
1,0,1,0,0,0,3,1743
1,0,1,0,0,0,3,1744
0,0,0,0,0,0,3,1745
1,0,1,0,0,0,3,1746
0,0,0,0,0,0,3,1747
0,1,1,0,0,0,3,1748
0,3,3,0,0,0,3,1749
0,1,1,0,0,0,3,1750
2,1,3,0,0,0,3,1751
0,0,0,0,0,0,3,1752
7,7,14,0,0,0,3,1753
109,131,240,0,0,0,3,1754
3,4,7,0,1,1,3,1755
1,1,2,0,0,0,3,1756
0,1,1,0,1,1,3,1757
2,0,2,0,0,0,3,1758
5,8,13,0,0,0,3,1759
3,0,3,0,0,0,3,1760
6,2,8,0,0,0,3,1761
0,0,0,0,0,0,3,1762
1,2,3,0,0,0,3,1763
2,2,4,0,0,0,3,1764
0,1,1,0,0,0,3,1765
3,1,4,0,0,0,3,1766
2,0,2,1,0,1,3,1767
0,1,1,0,0,0,3,1768
0,0,0,0,0,0,3,1769
4,0,4,0,0,0,3,1770
10,12,22,0,0,0,3,1771
4,0,4,0,0,0,3,1772
0,2,2,0,0,0,3,1773
1,1,2,0,0,0,3,1774
12,25,37,0,0,0,3,1775
9,8,17,0,0,0,3,1776
4,1,5,0,0,0,3,1777
0,1,1,0,0,0,3,1778
3,0,3,0,0,0,3,1779
2,0,2,0,0,0,3,1780
1,1,2,0,0,0,3,1781
3,0,3,0,0,0,3,1782
1,0,1,0,0,0,3,1783
5,3,8,0,0,0,3,1784
35,13,48,0,1,1,3,1785
1,3,4,0,0,0,3,1786
7,2,9,0,0,0,3,1787
1,0,1,0,0,0,3,1788
0,1,1,0,0,0,3,1789
3,2,5,0,0,0,3,1790
0,4,4,0,0,0,3,1791
1,1,2,0,0,0,3,1792
0,0,0,0,0,0,3,1793
2,2,4,1,0,1,3,1794
0,0,0,0,0,0,3,1795
151,60,211,1,0,1,3,1796
4,0,4,0,0,0,3,1797
0,0,0,0,0,0,3,1798
22,3,25,1,0,1,3,1799
20,9,29,0,0,0,3,1800
1,3,4,0,0,0,3,1801
1,1,2,0,0,0,3,1802
6,1,7,0,0,0,3,1803
3,2,5,0,0,0,3,1804
16,4,20,0,1,1,3,1805
0,0,0,0,0,0,3,1806
5,4,9,0,0,0,3,1807
9,6,15,0,0,0,3,1808
0,0,0,0,0,0,3,1809
1,0,1,0,0,0,3,1810
0,1,1,0,0,0,3,1811
0,0,0,0,0,0,3,1812
0,2,2,0,0,0,3,1813
6,18,24,0,0,0,3,1814
0,1,1,0,0,0,3,1815
6,7,13,0,0,0,3,1816
1,0,1,0,0,0,3,1817
3,1,4,0,0,0,3,1818
3,5,8,0,0,0,3,1819
1,3,4,0,0,0,3,1820
9,18,27,1,0,1,3,1821
0,5,5,0,0,0,3,1822
75,33,108,0,0,0,3,1823
5,1,6,0,0,0,3,1824
6,1,7,0,0,0,3,1825
8,3,11,0,0,0,3,1826
0,3,3,0,0,0,3,1827
5,1,6,0,0,0,3,1828
1,0,1,1,0,1,3,1829
11,9,20,0,0,0,3,1830
0,1,1,0,0,0,3,1831
1,0,1,0,0,0,3,1832
0,0,0,0,0,0,3,1833
5,2,7,0,0,0,3,1834
2,0,2,0,0,0,3,1835
4,1,5,0,0,0,3,1836
1,0,1,0,0,0,3,1837
2,0,2,0,0,0,3,1838
1,1,2,0,0,0,3,1839
16,12,28,0,0,0,3,1840
5,2,7,0,0,0,3,1841
1,4,5,0,0,0,3,1842
11,8,19,0,1,1,3,1843
0,0,0,0,0,0,3,1844
5,6,11,0,0,0,3,1845
0,1,1,0,0,0,3,1846
0,1,1,0,0,0,3,1847
5,0,5,0,0,0,3,1848
31,12,43,0,0,0,3,1849
1,0,1,0,0,0,3,1850
2,0,2,0,0,0,3,1851
0,0,0,0,0,0,3,1852
3,1,4,0,0,0,3,1853
7,4,11,0,0,0,3,1854
3,2,5,0,0,0,3,1855
4,0,4,0,0,0,3,1856
3,3,6,0,0,0,3,1857
10,5,15,2,0,2,3,1858
0,1,1,0,0,0,3,1859
0,0,0,0,0,0,3,1860
0,0,0,0,0,0,3,1861
1,0,1,0,0,0,3,1862
0,0,0,0,0,0,3,1863
2,0,2,0,0,0,3,1864
0,0,0,0,0,0,3,1865
1,0,1,0,0,0,3,1866
2,2,4,0,0,0,3,1867
3,1,4,0,0,0,3,1868
1,0,1,0,0,0,3,1869
19,35,54,0,0,0,3,1870
0,0,0,0,0,0,3,1871
8,3,11,0,0,0,3,1872
4,0,4,0,0,0,3,1873
2,1,3,0,0,0,3,1874
5,1,6,0,0,0,3,1875
1,0,1,0,0,0,3,1876
0,1,1,0,0,0,3,1877
1,1,2,0,0,0,3,1878
4,6,10,0,0,0,3,1879
6,1,7,0,0,0,3,1880
1,3,4,0,0,0,3,1881
4,0,4,0,0,0,3,1882
0,1,1,0,0,0,3,1883
20,11,31,0,0,0,3,1884
1,0,1,0,0,0,3,1885
0,1,1,0,0,0,3,1886
27,8,35,1,1,2,3,1887
12,7,19,0,0,0,3,1888
6,3,9,0,0,0,3,1889
0,0,0,0,0,0,3,1890
7,2,9,1,0,1,3,1891
7,2,9,0,0,0,3,1892
2,3,5,0,0,0,3,1893
7,1,8,0,0,0,3,1894
2,0,2,0,0,0,3,1895
6,21,27,0,0,0,3,1896
8,1,9,1,0,1,3,1897
1,1,2,0,0,0,3,1898
1,3,4,0,0,0,3,1899
4,3,7,0,0,0,3,1900
4,3,7,0,0,0,3,1901
0,0,0,0,0,0,3,1902
0,0,0,0,0,0,3,1903
11,13,24,0,0,0,3,1904
1,0,1,0,0,0,3,1905
3,1,4,0,0,0,3,1906
4,0,4,0,0,0,3,1907
1,6,7,0,0,0,3,1908
1,1,2,0,0,0,3,1909
0,1,1,0,0,0,3,1910
2,3,5,0,0,0,3,1911
2,0,2,0,0,0,3,1912
6,1,7,0,1,1,3,1913
11,0,11,0,0,0,3,1914
5,0,5,0,0,0,3,1915
3,0,3,0,0,0,3,1916
3,1,4,1,0,1,3,1917
4,12,16,0,0,0,3,1918
59,23,82,2,0,2,3,1919
1,1,2,0,0,0,3,1920
2,5,7,0,0,0,3,1921
3,0,3,0,0,0,3,1922
16,9,25,0,0,0,3,1923
65,45,110,0,0,0,3,1924
7,2,9,0,0,0,3,1925
1,2,3,0,0,0,3,1926
19,10,29,0,0,0,3,1927
2,0,2,0,0,0,3,1928
3,2,5,0,0,0,3,1929
3,0,3,0,0,0,3,1930
5,2,7,0,0,0,3,1931
10,3,13,0,0,0,3,1932
13,5,18,0,0,0,3,1933
1,4,5,0,0,0,3,1934
1,0,1,0,0,0,3,1935
4,4,8,0,0,0,3,1936
3,1,4,0,0,0,3,1937
10,3,13,0,0,0,3,1938
6,10,16,0,0,0,3,1939
4,2,6,0,0,0,3,1940
4,4,8,0,0,0,3,1941
15,4,19,0,0,0,3,1942
4,2,6,0,0,0,3,1943
13,5,18,0,1,1,3,1944
0,4,4,0,1,1,3,1945
2,4,6,0,0,0,3,1946
2,4,6,0,0,0,3,1947
7,6,13,0,0,0,3,1948
1,4,5,0,0,0,3,1949
11,10,21,0,1,1,3,1950
38,29,67,1,0,1,3,1951
15,11,26,0,0,0,3,1952
0,0,0,0,0,0,3,1953
0,0,0,0,0,0,3,1954
1,1,2,0,0,0,3,1955
3,4,7,0,0,0,3,1956
7,2,9,0,0,0,3,1957
2,5,7,0,0,0,3,1958
2,1,3,0,0,0,3,1959
2,0,2,0,0,0,3,1960
1,1,2,0,0,0,3,1961
1,0,1,0,0,0,3,1962
2,4,6,0,0,0,3,1963
2,1,3,0,0,0,3,1964
0,0,0,0,0,0,3,1965
11,5,16,1,0,1,3,1966
1,0,1,0,0,0,3,1967
1,0,1,0,0,0,3,1968
3,5,8,0,0,0,3,1969
0,2,2,0,0,0,3,1970
0,0,0,0,0,0,3,1971
80,23,103,0,1,1,3,1972
6,0,6,0,0,0,3,1973
6,3,9,0,0,0,3,1974
0,0,0,0,0,0,3,1975
7,0,7,0,0,0,3,1976
2,4,6,0,0,0,3,1977
15,23,38,0,0,0,3,1978
2381,3246,5627,23,39,62,3,1979
1217,2167,3384,8,8,16,3,1980
179,108,287,0,0,0,3,1981
523,1480,2003,11,18,29,3,1982
948,2745,3693,5,20,25,3,1983
30,57,87,0,0,0,3,1984
15,31,46,0,0,0,3,1985
1295,1243,2538,15,12,27,3,1986
2249,5130,7379,15,27,42,3,1987
14,5,19,0,0,0,3,1988
128,62,190,0,0,0,3,1989
328,241,569,1,1,2,3,1990
62,8,70,0,0,0,3,1991
78,94,172,0,0,0,3,1992
74,146,220,1,2,3,3,1993
192,258,450,1,4,5,3,1994
367,286,653,3,3,6,3,1995
62,74,136,0,0,0,3,1996
122,185,307,3,7,10,3,1997
7,14,21,0,0,0,3,1998
6,16,22,0,1,1,3,1999
17,11,28,0,1,1,3,2000
32,2,34,0,0,0,3,2001
4,2,6,0,1,1,3,2002
38,4,42,0,0,0,3,2003
12,7,19,0,0,0,3,2004
3,6,9,0,0,0,3,2005
0,2,2,0,0,0,3,2006
0,0,0,0,0,0,3,2007
2,1,3,0,1,1,3,2008
19,14,33,1,1,2,3,2009
3,3,6,0,1,1,3,2010
0,2,2,0,1,1,3,2011
1,0,1,0,0,0,3,2012
1,6,7,0,1,1,3,2013
3210,3117,6327,14,6,20,3,2014
463,510,973,5,2,7,3,2015
248,190,438,2,0,2,3,2016
221,180,401,2,2,4,3,2017
83,56,139,0,0,0,3,2018
0,0,0,0,0,0,3,2019
14,9,23,0,0,0,3,2020
60,38,98,0,0,0,3,2021
138,195,333,1,2,3,3,2022
0,0,0,0,0,0,3,2023
192,173,365,5,1,6,3,2024
397,343,740,7,9,16,3,2025
16,6,22,0,1,1,3,2026
11,9,20,0,0,0,3,2027
1,2,3,0,0,0,3,2028
0,2,2,0,0,0,3,2029
129,41,170,0,0,0,3,2030
15,5,20,0,0,0,3,2031
11,7,18,0,0,0,3,2032
1,4,5,0,0,0,3,2033
60,108,168,1,0,1,3,2034
35,21,56,1,0,1,3,2035
20,13,33,0,1,1,3,2036
4,2,6,0,0,0,3,2037
9,6,15,0,0,0,3,2038
6,8,14,0,0,0,3,2039
2,2,4,0,0,0,3,2040
25,12,37,0,0,0,3,2041
2,2,4,0,0,0,3,2042
21,23,44,0,0,0,3,2043
2315,5312,7627,23,56,79,3,2044
70,54,124,0,0,0,3,2045
9,7,16,0,0,0,3,2046
1,2,3,0,0,0,3,2047
2,0,2,0,0,0,3,2048
3,1,4,0,0,0,3,2049
2,2,4,0,0,0,3,2050
0,4,4,0,0,0,3,2051
443,466,909,36,27,63,3,2052
102,89,191,6,2,8,3,2053
112,170,282,9,4,13,3,2054
145,215,360,10,10,20,3,2055
555,395,950,69,16,85,3,2056
25,22,47,0,1,1,3,2057
0,0,0,0,0,0,3,2058
5,1,6,0,0,0,3,2059
1,4,5,0,0,0,3,2060
0,1,1,0,0,0,3,2061
4,0,4,2,0,2,3,2062
14,45,59,0,2,2,3,2063
0,1,1,0,0,0,3,2064
2,2,4,0,0,0,3,2065
13,3,16,0,0,0,3,2066
6,8,14,0,0,0,3,2067
40,106,146,0,2,2,3,2068
12,21,33,0,0,0,3,2069
0,1,1,0,0,0,3,2070
4,4,8,0,0,0,3,2071
1,2,3,0,0,0,3,2072
0,2,2,0,1,1,3,2073
91,413,504,1,10,11,3,2074
1,2,3,0,0,0,3,2075
2,0,2,0,0,0,3,2076
0,0,0,0,0,0,3,2077
0,4,4,0,0,0,3,2078
11,5,16,0,0,0,3,2079
17,36,53,1,0,1,3,2080
6764,12050,18814,46,63,109,3,2081
0,0,0,0,0,0,3,2082
0,1,1,0,0,0,3,2083
0,0,0,0,0,0,3,2084
0,1,1,0,0,0,3,2085
0,0,0,0,0,0,3,2086
0,1,1,0,0,0,3,2087
9,13,22,0,0,0,3,2088
1,0,1,0,0,0,3,2089
2,12,14,0,0,0,3,2090
1,2,3,0,0,0,3,2091
2,4,6,0,0,0,3,2092
0,0,0,0,0,0,3,2093
0,2,2,0,0,0,3,2094
0,0,0,0,0,0,3,2095
0,0,0,0,0,0,3,2096
0,1,1,0,0,0,3,2097
0,0,0,0,0,0,3,2098
0,1,1,0,0,0,3,2099
1,4,5,0,0,0,3,2100
2,0,2,0,0,0,3,2101
0,0,0,0,0,0,3,2102
1,0,1,0,0,0,3,2103
0,0,0,0,0,0,3,2104
3,5,8,0,0,0,3,2105
0,0,0,0,0,0,3,2106
0,1,1,0,0,0,3,2107
1,0,1,0,0,0,3,2108
0,1,1,0,0,0,3,2109
2,3,5,1,1,2,3,2110
5,32,37,0,1,1,3,2111
0,0,0,0,0,0,3,2112
0,0,0,0,0,0,3,2113
1,1,2,0,0,0,3,2114
0,0,0,0,0,0,3,2115
0,0,0,0,0,0,3,2116
2,2,4,0,0,0,3,2117
0,0,0,0,0,0,3,2118
0,0,0,0,0,0,3,2119
1,0,1,0,0,0,3,2120
0,0,0,0,0,0,3,2121
0,1,1,0,0,0,3,2122
0,0,0,0,0,0,3,2123
1,0,1,0,0,0,3,2124
0,2,2,0,0,0,3,2125
0,0,0,0,0,0,3,2126
0,0,0,0,0,0,3,2127
0,0,0,0,0,0,3,2128
0,2,2,0,0,0,3,2129
0,2,2,0,0,0,3,2130
0,0,0,0,0,0,3,2131
0,1,1,0,0,0,3,2132
0,1,1,0,0,0,3,2133
0,0,0,0,0,0,3,2134
0,0,0,0,0,0,3,2135
2,2,4,0,0,0,3,2136
1,0,1,0,0,0,3,2137
0,1,1,0,0,0,3,2138
0,0,0,0,0,0,3,2139
0,0,0,0,0,0,3,2140
40,31,71,0,0,0,3,2141
142,110,252,1,1,2,3,2142
16,5,21,1,0,1,3,2143
5,3,8,0,0,0,3,2144
23,7,30,0,0,0,3,2145
15,4,19,0,0,0,3,2146
48,56,104,1,1,2,3,2147
29,54,83,1,0,1,3,2148
11,32,43,0,0,0,3,2149
257,458,715,2,18,20,3,2150
85,188,273,1,8,9,3,2151
24,57,81,0,1,1,3,2152
49,25,74,2,0,2,3,2153
125,115,240,0,3,3,3,2154
88,89,177,1,0,1,3,2155
13,11,24,0,0,0,3,2156
13,16,29,0,0,0,3,2157
1,6,7,0,0,0,3,2158
11,5,16,0,0,0,3,2159
18,8,26,0,0,0,3,2160
12,17,29,0,0,0,3,2161
77,59,136,1,2,3,3,2162
29,17,46,0,0,0,3,2163
65,154,219,2,1,3,3,2164
38,42,80,0,0,0,3,2165
95,85,180,1,0,1,3,2166
78,45,123,0,0,0,3,2167
52,22,74,0,0,0,3,2168
33,4,37,1,0,1,3,2169
5,1,6,0,0,0,3,2170
8,13,21,0,0,0,3,2171
477,520,997,2,0,2,3,2172
10,4,14,0,0,0,3,2173
11,50,61,0,0,0,3,2174
14,1,15,0,0,0,3,2175
25,7,32,1,0,1,3,2176
3,2,5,0,0,0,3,2177
59,10,69,1,0,1,3,2178
1,0,1,0,0,0,3,2179
1,0,1,0,0,0,3,2180
2,2,4,0,0,0,3,2181
6,3,9,0,0,0,3,2182
2,2,4,0,0,0,3,2183
4,2,6,0,0,0,3,2184
0,1,1,0,0,0,3,2185
8,8,16,0,0,0,3,2186
0,6,6,0,0,0,3,2187
12,7,19,0,0,0,3,2188
4,1,5,0,0,0,3,2189
4,3,7,0,0,0,3,2190
5,7,12,0,0,0,3,2191
3,1,4,0,0,0,3,2192
0,3,3,0,0,0,3,2193
2,7,9,0,0,0,3,2194
10,1,11,0,0,0,3,2195
3,3,6,0,0,0,3,2196
12,6,18,0,0,0,3,2197
47,30,77,1,0,1,3,2198
95,44,139,0,0,0,3,2199
646,244,890,4,1,5,3,2200
89,33,122,0,0,0,3,2201
10,3,13,0,0,0,3,2202
1,0,1,0,0,0,3,2203
12,3,15,0,0,0,3,2204
5,4,9,0,0,0,3,2205
0,0,0,0,0,0,3,2206
4,1,5,0,0,0,3,2207
0,1,1,0,0,0,3,2208
2,0,2,0,0,0,3,2209
7,2,9,0,0,0,3,2210
6,6,12,0,0,0,3,2211
3,2,5,0,0,0,3,2212
16,15,31,0,0,0,3,2213
8,5,13,1,0,1,3,2214
0,3,3,0,0,0,3,2215
3,0,3,0,0,0,3,2216
2,0,2,0,0,0,3,2217
2,2,4,0,0,0,3,2218
1,2,3,0,0,0,3,2219
1,0,1,0,0,0,3,2220
0,9,9,0,0,0,3,2221
7,1,8,0,0,0,3,2222
5,0,5,0,0,0,3,2223
2,5,7,0,0,0,3,2224
0,1,1,0,0,0,3,2225
2,1,3,0,0,0,3,2226
1,3,4,0,0,0,3,2227
17,3,20,0,0,0,3,2228
6,2,8,0,0,0,3,2229
1,1,2,0,0,0,3,2230
4,17,21,0,0,0,3,2231
1,1,2,0,0,0,3,2232
9,1,10,0,0,0,3,2233
1,0,1,0,0,0,3,2234
5,1,6,0,0,0,3,2235
4,1,5,0,0,0,3,2236
1,3,4,0,0,0,3,2237
1,0,1,0,0,0,3,2238
2,0,2,0,0,0,3,2239
0,1,1,0,0,0,3,2240
1,0,1,0,0,0,3,2241
0,0,0,0,0,0,3,2242
5,6,11,0,0,0,3,2243
0,1,1,0,0,0,3,2244
2,1,3,0,0,0,3,2245
4,0,4,0,0,0,3,2246
4,16,20,0,1,1,3,2247
1,1,2,0,0,0,3,2248
7,1,8,0,0,0,3,2249
4676,9774,14450,11,50,61,3,2250
5,8,13,1,0,1,3,2251
4,3,7,0,0,0,3,2252
0,0,0,0,0,0,3,2253
1,0,1,0,0,0,3,2254
3,3,6,0,0,0,3,2255
0,0,0,0,0,0,3,2256
236,111,347,2,1,3,3,2257
2,8,10,0,0,0,3,2258
3,1,4,0,0,0,3,2259
1,2,3,0,0,0,3,2260
2,0,2,0,0,0,3,2261
2,0,2,0,0,0,3,2262
1,1,2,0,0,0,3,2263
1,0,1,0,0,0,3,2264
0,1,1,0,0,0,3,2265
0,0,0,0,0,0,3,2266
1,0,1,0,0,0,3,2267
0,1,1,0,0,0,3,2268
3,2,5,0,0,0,3,2269
1,4,5,0,0,0,3,2270
1,6,7,0,0,0,3,2271
0,0,0,0,0,0,3,2272
1,0,1,0,0,0,3,2273
15,1,16,0,0,0,3,2274
1,2,3,0,0,0,3,2275
2,5,7,0,0,0,3,2276
0,0,0,0,0,0,3,2277
20,37,57,0,0,0,3,2278
3,2,5,0,0,0,3,2279
12,38,50,0,0,0,3,2280
0,0,0,0,0,0,3,2281
4,0,4,0,0,0,3,2282
0,0,0,0,0,0,3,2283
1,2,3,0,1,1,3,2284
2,1,3,0,0,0,3,2285
1,1,2,0,0,0,3,2286
0,0,0,0,0,0,3,2287
1,0,1,0,0,0,3,2288
3,0,3,0,0,0,3,2289
0,0,0,0,0,0,3,2290
1,0,1,0,0,0,3,2291
4,0,4,0,0,0,3,2292
2,0,2,0,0,0,3,2293
1,1,2,0,0,0,3,2294
0,1,1,0,0,0,3,2295
32,30,62,2,0,2,3,2296
0,0,0,0,0,0,3,2297
140,125,265,1,0,1,3,2298
78,67,145,0,0,0,3,2299
80,48,128,2,1,3,3,2300
8,4,12,0,0,0,3,2301
2,7,9,0,0,0,3,2302
11,3,14,0,0,0,3,2303
4,0,4,0,0,0,3,2304
5,0,5,0,0,0,3,2305
1,3,4,0,0,0,3,2306
0,1,1,0,0,0,3,2307
8,5,13,0,0,0,3,2308
0,1,1,0,0,0,3,2309
1,0,1,0,0,0,3,2310
0,3,3,0,0,0,3,2311
0,0,0,0,0,0,3,2312
0,0,0,0,0,0,3,2313
1,0,1,0,0,0,3,2314
3,0,3,0,0,0,3,2315
44,42,86,1,0,1,3,2316
23,43,66,0,0,0,3,2317
80,175,255,1,3,4,3,2318
3,1,4,0,0,0,3,2319
16,3,19,0,0,0,3,2320
28,5,33,0,0,0,3,2321
1618,1714,3332,12,10,22,3,2322
12,3,15,0,0,0,3,2323
14,4,18,0,0,0,3,2324
8,5,13,0,0,0,3,2325
22,16,38,1,0,1,3,2326
30,12,42,1,1,2,3,2327
19,3,22,0,0,0,3,2328
844,653,1497,1,3,4,3,2329
4145,2375,6520,3,1,4,3,2330
0,4,4,0,0,0,3,2331
48,157,205,0,3,3,3,2332
3,7,10,0,0,0,3,2333
8,24,32,0,0,0,3,2334
2,16,18,0,0,0,3,2335
13,114,127,0,3,3,3,2336
5,21,26,0,0,0,3,2337
223,110,333,1,0,1,3,2338
121,106,227,0,1,1,3,2339
18,10,28,0,0,0,3,2340
16,33,49,0,2,2,3,2341
322,81,403,4,4,8,3,2342
357,101,458,5,3,8,3,2343
128,24,152,1,0,1,3,2344
7,6,13,0,0,0,3,2345
17,6,23,0,0,0,3,2346
13,0,13,0,0,0,3,2347
11,10,21,0,0,0,3,2348
8,4,12,0,0,0,3,2349
12,10,22,0,0,0,3,2350
49,22,71,3,0,3,3,2351
3,0,3,0,0,0,3,2352
94,43,137,0,0,0,3,2353
15,24,39,0,0,0,3,2354
17,9,26,0,0,0,3,2355
8,16,24,0,0,0,3,2356
33,3,36,0,0,0,3,2357
4,3,7,0,0,0,3,2358
3,0,3,0,0,0,3,2359
9,1,10,0,0,0,3,2360
1,2,3,0,0,0,3,2361
37,5,42,0,0,0,3,2362
1533,674,2207,17,13,30,3,2363
785,1079,1864,22,18,40,3,2364
12,9,21,0,0,0,3,2365
11,25,36,0,1,1,3,2366
3,1,4,0,0,0,3,2367
39,2,41,1,0,1,3,2368
135,240,375,4,9,13,3,2369
2,6,8,0,0,0,3,2370
4,2,6,0,0,0,3,2371
29,4,33,0,0,0,3,2372
20,2,22,1,0,1,3,2373
77,32,109,0,0,0,3,2374
41,11,52,0,0,0,3,2375
9,2,11,0,0,0,3,2376
10,3,13,0,0,0,3,2377
9,0,9,0,0,0,3,2378
8,7,15,1,0,1,3,2379
2,2,4,0,0,0,3,2380
15,6,21,0,0,0,3,2381
8,4,12,0,0,0,3,2382
41,96,137,1,0,1,3,2383
74,157,231,0,1,1,3,2384
0,0,0,0,0,0,3,2385
0,0,0,0,0,0,3,2386
0,0,0,0,0,0,3,2387
0,0,0,0,0,0,3,2388
0,0,0,0,0,0,3,2389
16,12,28,0,0,0,3,2390
1,1,2,0,0,0,3,2391
0,0,0,0,0,0,3,2392
2,0,2,0,0,0,3,2393
1,5,6,0,0,0,3,2394
1,1,2,0,0,0,3,2395
1,0,1,0,0,0,3,2396
4,3,7,0,0,0,3,2397
3,8,11,0,0,0,3,2398
4,6,10,0,0,0,3,2399
8,34,42,0,0,0,3,2400
9,1,10,0,0,0,3,2401
1,1,2,0,0,0,3,2402
2,2,4,0,0,0,3,2403
13,6,19,0,0,0,3,2404
44,59,103,0,0,0,3,2405
10,7,17,0,0,0,3,2406
10,11,21,0,0,0,3,2407
818,501,1319,5,0,5,3,2408
2,0,2,0,0,0,3,2409
0,3,3,0,0,0,3,2410
7,6,13,0,0,0,3,2411
0,0,0,0,0,0,3,2412
12,19,31,1,0,1,3,2413
23,23,46,0,0,0,3,2414
2,6,8,0,0,0,3,2415
2,3,5,0,0,0,3,2416
1,5,6,1,0,1,3,2417
0,14,14,0,0,0,3,2418
2,1,3,0,0,0,3,2419
0,0,0,0,0,0,3,2420
6,3,9,0,0,0,3,2421
3,6,9,0,0,0,3,2422
1,0,1,0,0,0,3,2423
1,0,1,0,0,0,3,2424
0,0,0,0,0,0,3,2425
0,4,4,0,0,0,3,2426
2,12,14,0,0,0,3,2427
0,0,0,0,0,0,3,2428
150,138,288,0,0,0,3,2429
3,2,5,0,0,0,3,2430
6,2,8,0,0,0,3,2431
25,5,30,2,1,3,3,2432
25,16,41,0,0,0,3,2433
3,1,4,0,0,0,3,2434
0,1,1,0,0,0,3,2435
2,2,4,0,0,0,3,2436
2,6,8,0,0,0,3,2437
2,6,8,0,0,0,3,2438
1,0,1,0,0,0,3,2439
1,0,1,0,0,0,3,2440
21,115,136,0,2,2,3,2441
0,1,1,0,0,0,3,2442
1,11,12,0,0,0,3,2443
4,6,10,0,1,1,3,2444
2,0,2,0,0,0,3,2445
96,40,136,1,1,2,3,2446
18,15,33,0,1,1,3,2447
16,21,37,0,0,0,3,2448
13,12,25,0,0,0,3,2449
27,11,38,1,1,2,3,2450
32,7,39,0,0,0,3,2451
0,0,0,0,0,0,3,2452
0,0,0,0,0,0,3,2453
15,0,15,0,0,0,3,2454
50,7,57,3,0,3,3,2455
20,11,31,0,0,0,3,2456
7908,6224,14132,190,122,312,3,2457
8,1,9,0,0,0,3,2458
295,661,956,2,2,4,3,2459
42,8,50,2,0,2,3,2460
14,3,17,0,0,0,3,2461
9,3,12,0,0,0,3,2462
2,4,6,0,0,0,3,2463
2,2,4,0,0,0,3,2464
13,6,19,0,0,0,3,2465
33,16,49,0,0,0,3,2466
4,12,16,0,0,0,3,2467
13,5,18,0,0,0,3,2468
0,1,1,0,0,0,3,2469
0,2,2,0,0,0,3,2470
1,0,1,0,0,0,3,2471
2,2,4,0,0,0,3,2472
0,2,2,0,0,0,3,2473
1,1,2,0,0,0,3,2474
4,0,4,0,0,0,3,2475
11,16,27,0,1,1,3,2476
196,78,274,1,2,3,3,2477
5,4,9,0,0,0,3,2478
9,7,16,0,0,0,3,2479
8,4,12,0,0,0,3,2480
33,8,41,0,1,1,3,2481
23,10,33,0,0,0,3,2482
1,1,2,0,0,0,3,2483
0,1,1,0,0,0,3,2484
0,0,0,0,0,0,3,2485
0,0,0,0,0,0,3,2486
3,0,3,0,0,0,3,2487
1,2,3,0,0,0,3,2488
0,1,1,0,0,0,3,2489
0,0,0,0,0,0,3,2490
1,0,1,0,0,0,3,2491
0,1,1,0,0,0,3,2492
1,0,1,0,0,0,3,2493
1,1,2,0,0,0,3,2494
0,0,0,0,0,0,3,2495
17,5,22,0,0,0,3,2496
6,1,7,0,0,0,3,2497
30,10,40,0,0,0,3,2498
3,1,4,0,0,0,3,2499
4,4,8,0,0,0,3,2500
0,1,1,0,0,0,3,2501
6,9,15,0,0,0,3,2502
6978,9203,16181,16,20,36,3,2503
2,3,5,0,1,1,3,2504
0,1,1,0,0,0,3,2505
6,2,8,2,0,2,3,2506
1,0,1,0,0,0,3,2507
0,1,1,0,0,0,3,2508
2,2,4,0,0,0,3,2509
1,0,1,0,0,0,3,2510
5,2,7,0,0,0,3,2511
2,0,2,0,0,0,3,2512
3,1,4,0,0,0,3,2513
2,0,2,0,0,0,3,2514
3,0,3,0,0,0,3,2515
2,0,2,0,0,0,3,2516
99,42,141,2,3,5,3,2517
133,263,396,2,0,2,3,2518
40,15,55,0,0,0,3,2519
6,5,11,0,0,0,3,2520
1,0,1,0,0,0,3,2521
0,1,1,0,0,0,3,2522
5,3,8,0,0,0,3,2523
7,2,9,0,0,0,3,2524
3,0,3,0,0,0,3,2525
6,0,6,0,0,0,3,2526
21,58,79,1,1,2,3,2527
34,33,67,1,0,1,3,2528
6,2,8,0,0,0,3,2529
1,5,6,0,0,0,3,2530
8,11,19,0,0,0,3,2531
62,11,73,1,0,1,3,2532
3,9,12,0,1,1,3,2533
28,35,63,0,1,1,3,2534
12,8,20,0,0,0,3,2535
1,2,3,0,0,0,3,2536
1,0,1,0,0,0,3,2537
60,50,110,1,1,2,3,2538
2546,2307,4853,23,25,48,3,2539
370,191,561,5,0,5,3,2540
1,0,1,0,0,0,3,2541
4,2,6,0,0,0,3,2542
85,13,98,1,0,1,3,2543
99,45,144,3,0,3,3,2544
120,23,143,0,0,0,3,2545
30,31,61,0,1,1,3,2546
49,28,77,1,0,1,3,2547
1,5,6,0,0,0,3,2548
30,12,42,0,0,0,3,2549
25,11,36,1,0,1,3,2550
3,1,4,0,0,0,3,2551
18,15,33,2,0,2,3,2552
0,0,0,0,0,0,3,2553
0,3,3,0,0,0,3,2554
6,4,10,0,0,0,3,2555
2,2,4,0,0,0,3,2556
0,0,0,0,0,0,3,2557
426,545,971,21,38,59,3,2558
11,3,14,0,0,0,3,2559
28,7,35,1,0,1,3,2560
6,0,6,0,0,0,3,2561
1,0,1,0,0,0,3,2562
6,1,7,0,0,0,3,2563
12,2,14,0,0,0,3,2564
7,1,8,0,0,0,3,2565
0,0,0,0,0,0,3,2566
1,0,1,0,0,0,3,2567
7,13,20,0,0,0,3,2568
13,11,24,1,0,1,3,2569
24,12,36,1,0,1,3,2570
0,0,0,0,0,0,3,2571
0,1,1,0,0,0,3,2572
47,18,65,1,0,1,3,2573
7,0,7,0,0,0,3,2574
4,1,5,0,0,0,3,2575
0,0,0,0,0,0,3,2576
1,6,7,0,0,0,3,2577
0,2,2,0,1,1,3,2578
1,0,1,0,0,0,3,2579
103,36,139,5,0,5,3,2580
22,4,26,0,0,0,3,2581
192,131,323,2,0,2,3,2582
46,3,49,1,0,1,3,2583
54,71,125,0,1,1,3,2584
1,0,1,0,0,0,3,2585
22,3,25,0,0,0,3,2586
5,2,7,0,0,0,3,2587
8,21,29,0,0,0,3,2588
10,7,17,0,0,0,3,2589
4,3,7,0,0,0,3,2590
3,2,5,0,0,0,3,2591
14,4,18,0,0,0,3,2592
8,6,14,0,0,0,3,2593
19,9,28,0,0,0,3,2594
56,22,78,2,1,3,3,2595
3,4,7,0,0,0,3,2596
7,15,22,0,0,0,3,2597
18,11,29,0,1,1,3,2598
23,10,33,0,0,0,3,2599
4,1,5,0,0,0,3,2600
1,8,9,0,1,1,3,2601
125,7,132,0,0,0,3,2602
0,0,0,0,0,0,3,2603
185,109,294,0,0,0,3,2604
185,427,612,1,2,3,3,2605
5,3,8,0,0,0,3,2606
30,31,61,1,0,1,3,2607
107,27,134,0,0,0,3,2608
63,29,92,0,0,0,3,2609
4,4,8,0,0,0,3,2610
35,24,59,0,1,1,3,2611
1,0,1,0,0,0,3,2612
13,6,19,0,0,0,3,2613
48,226,274,0,5,5,3,2614
52,24,76,1,0,1,3,2615
41,10,51,0,0,0,3,2616
111,21,132,0,0,0,3,2617
35,4,39,0,0,0,3,2618
5,5,10,0,0,0,3,2619
185,774,959,2,2,4,3,2620
18,21,39,0,2,2,3,2621
24,32,56,0,0,0,3,2622
5096,1577,6673,47,16,63,3,2623
20,9,29,0,0,0,3,2624
7,0,7,0,0,0,3,2625
6,4,10,0,0,0,3,2626
6,0,6,0,0,0,3,2627
11,6,17,0,0,0,3,2628
17,18,35,0,0,0,3,2629
36,11,47,0,0,0,3,2630
10,0,10,0,0,0,3,2631
475,516,991,8,3,11,3,2632
1982,4531,6513,34,48,82,3,2633
473,262,735,4,3,7,3,2634
2,0,2,0,0,0,3,2635
2,1,3,0,0,0,3,2636
24,7,31,0,0,0,3,2637
21,9,30,0,0,0,3,2638
2,2,4,0,0,0,3,2639
5,3,8,0,0,0,3,2640
1148,1055,2203,6,10,16,3,2641
295,239,534,1,3,4,3,2642
1,3,4,0,0,0,3,2643
1,4,5,0,0,0,3,2644
18,8,26,0,0,0,3,2645
50,32,82,0,0,0,3,2646
1,1,2,0,1,1,3,2647
15,4,19,0,0,0,3,2648
4,0,4,0,0,0,3,2649
3,0,3,0,0,0,3,2650
4,3,7,0,0,0,3,2651
1,2,3,0,0,0,3,2652
88,81,169,0,0,0,3,2653
12,5,17,0,0,0,3,2654
4,5,9,0,0,0,3,2655
1,0,1,0,0,0,3,2656
5,4,9,0,0,0,3,2657
4,5,9,1,1,2,3,2658
0,0,0,0,0,0,3,2659
53,17,70,2,1,3,3,2660
8815,3909,12724,1,3,4,3,2661
0,0,0,0,0,0,3,2662
37,52,89,0,0,0,3,2663
780,160,940,20,2,22,3,2664
25,4,29,0,0,0,3,2665
9,0,9,0,0,0,3,2666
7,5,12,0,0,0,3,2667
297,149,446,9,3,12,3,2668
3,0,3,0,0,0,3,2669
421,71,492,2,1,3,3,2670
9,0,9,0,0,0,3,2671
6,1,7,0,0,0,3,2672
8,8,16,0,1,1,3,2673
14,5,19,0,0,0,3,2674
9,1,10,0,0,0,3,2675
38,8,46,1,0,1,3,2676
35,6,41,0,0,0,3,2677
322,70,392,1,0,1,3,2678
113,404,517,4,1,5,3,2679
2404,4913,7317,25,21,46,3,2680
33,82,115,0,2,2,3,2681
3,5,8,0,0,0,3,2682
32,8,40,0,0,0,3,2683
71,54,125,0,0,0,3,2684
27,2,29,0,0,0,3,2685
0,0,0,-51,-24,-75,3,2686
1,1,2,0,0,0,3,2687
2,2,4,0,0,0,3,2688
3,1,4,0,0,0,3,2689
8,6,14,0,0,0,3,2690
2,0,2,0,0,0,3,2691
2,3,5,0,0,0,3,2692
1,4,5,0,0,0,3,2693
0,1,1,0,0,0,3,2694
1,2,3,0,0,0,3,2695
5,4,9,0,0,0,3,2696
2,0,2,0,0,0,3,2697
0,1,1,0,0,0,3,2698
5,2,7,0,0,0,3,2699
3,2,5,0,0,0,3,2700
29,15,44,0,0,0,3,2701
3,1,4,0,0,0,3,2702
4,3,7,0,0,0,3,2703
126,196,322,0,1,1,3,2704
17191,16964,34155,9,7,16,3,2705
22,14,36,0,1,1,3,2706
33,22,55,0,1,1,3,2707
2623,2486,5109,6,9,15,3,2708
9,4,13,0,0,0,3,2709
7,5,12,0,0,0,3,2710
5,5,10,0,0,0,3,2711
4,5,9,0,0,0,3,2712
36,17,53,1,1,2,3,2713
51,29,80,1,0,1,3,2714
2,4,6,0,0,0,3,2715
1,0,1,0,0,0,3,2716
67,42,109,1,3,4,3,2717
2,1,3,0,0,0,3,2718
3,6,9,0,0,0,3,2719
3,0,3,0,0,0,3,2720
79,214,293,0,1,1,3,2721
43,32,75,1,0,1,3,2722
1422,4414,5836,8,10,18,3,2723
73,548,621,0,0,0,3,2724
52,20,72,0,0,0,3,2725
41,22,63,3,0,3,3,2726
20,6,26,0,0,0,3,2727
1,0,1,0,0,0,3,2728
344,357,701,0,0,0,3,2729
50,41,91,0,0,0,3,2730
24,5,29,0,0,0,3,2731
85,18,103,0,0,0,3,2732
86,27,113,3,0,3,3,2733
10,9,19,0,0,0,3,2734
4,3,7,0,0,0,3,2735
212,682,894,5,5,10,3,2736
28,25,53,0,0,0,3,2737
2,5,7,0,0,0,3,2738
4,1,5,0,0,0,3,2739
0,2,2,0,0,0,3,2740
0,1,1,0,0,0,3,2741
1,0,1,0,0,0,3,2742
61,18,79,0,0,0,3,2743
71,147,218,3,5,8,3,2744
267,817,1084,4,15,19,3,2745
0,0,0,0,0,0,3,2746
525,164,689,0,0,0,3,2747
398,187,585,3,1,4,3,2748
40,78,118,0,1,1,3,2749
0,0,0,0,0,0,3,2750
0,0,0,0,0,0,3,2751
2,0,2,0,0,0,3,2752
0,0,0,0,0,0,3,2753
2,4,6,0,0,0,3,2754
6,1,7,0,0,0,3,2755
2,0,2,0,0,0,3,2756
17,23,40,0,0,0,3,2757
13,49,62,0,2,2,3,2758
144,17,161,0,0,0,3,2759
8,7,15,0,0,0,3,2760
2,3,5,0,0,0,3,2761
2,1,3,0,0,0,3,2762
0,3,3,0,0,0,3,2763
0,0,0,0,0,0,3,2764
0,1,1,0,0,0,3,2765
2,3,5,0,1,1,3,2766
2,0,2,0,0,0,3,2767
1,1,2,0,0,0,3,2768
10,5,15,0,0,0,3,2769
5,5,10,0,0,0,3,2770
1,0,1,0,0,0,3,2771
0,0,0,0,0,0,3,2772
2,15,17,0,0,0,3,2773
0,0,0,0,0,0,3,2774
2363,2324,4687,19,15,34,3,2775
8,4,12,0,0,0,3,2776
57,56,113,0,0,0,3,2777
20,19,39,0,0,0,3,2778
12,3,15,0,0,0,3,2779
35,46,81,0,0,0,3,2780
0,0,0,0,0,0,3,2781
5,10,15,0,0,0,3,2782
6,7,13,0,0,0,3,2783
29,59,88,0,1,1,3,2784
6,5,11,0,0,0,3,2785
27,21,48,0,0,0,3,2786
4,9,13,0,0,0,3,2787
8,8,16,0,0,0,3,2788
76,50,126,4,3,7,3,2789
0,0,0,0,0,0,3,2790
42,73,115,1,1,2,3,2791
2,3,5,0,0,0,3,2792
2,0,2,0,0,0,3,2793
2,1,3,0,0,0,3,2794
8,2,10,0,0,0,3,2795
2,9,11,0,0,0,3,2796
0,4,4,0,0,0,3,2797
2,5,7,0,0,0,3,2798
1,1,2,0,0,0,3,2799
0,2,2,0,0,0,3,2800
2,0,2,0,0,0,3,2801
3,8,11,0,0,0,3,2802
7,20,27,0,0,0,3,2803
1,1,2,0,0,0,3,2804
0,2,2,0,0,0,3,2805
0,0,0,0,0,0,3,2806
5,1,6,0,0,0,3,2807
6,5,11,0,0,0,3,2808
3,2,5,0,0,0,3,2809
1,1,2,0,0,0,3,2810
3,3,6,0,0,0,3,2811
12,5,17,0,0,0,3,2812
2,2,4,0,0,0,3,2813
14,2,16,0,0,0,3,2814
3,4,7,0,0,0,3,2815
4,0,4,0,0,0,3,2816
4,9,13,0,0,0,3,2817
0,4,4,0,0,0,3,2818
14,51,65,0,3,3,3,2819
2,2,4,0,0,0,3,2820
0,1,1,0,0,0,3,2821
3,3,6,0,0,0,3,2822
4,1,5,0,0,0,3,2823
4903,21562,26465,7,10,17,3,2824
2069,2414,4483,0,5,5,3,2825
3,2,5,0,0,0,3,2826
1,0,1,0,0,0,3,2827
32,1,33,0,0,0,3,2828
2,2,4,0,0,0,3,2829
0,0,0,0,0,0,3,2830
1,0,1,0,0,0,3,2831
0,1,1,0,0,0,3,2832
1,0,1,0,0,0,3,2833
0,3,3,0,0,0,3,2834
4,2,6,1,0,1,3,2835
5,3,8,0,0,0,3,2836
1,0,1,0,0,0,3,2837
0,0,0,0,0,0,3,2838
14,4,18,0,0,0,3,2839
11,7,18,1,0,1,3,2840
11,2,13,0,1,1,3,2841
15,9,24,0,0,0,3,2842
2,1,3,0,0,0,3,2843
5,0,5,0,0,0,3,2844
0,0,0,0,0,0,3,2845
7,3,10,0,0,0,3,2846
2,6,8,0,0,0,3,2847
16,51,67,0,1,1,3,2848
9,7,16,0,0,0,3,2849
26,90,116,2,1,3,3,2850
21,20,41,0,0,0,3,2851
0,1,1,0,0,0,3,2852
81,259,340,0,4,4,3,2853
25,33,58,0,0,0,3,2854
26,31,57,0,0,0,3,2855
38,107,145,0,1,1,3,2856
16,25,41,3,1,4,3,2857
20,17,37,1,0,1,3,2858
17,8,25,0,0,0,3,2859
23,52,75,5,12,17,3,2860
4,12,16,0,0,0,3,2861
8,3,11,0,0,0,3,2862
1,1,2,0,0,0,3,2863
0,0,0,0,0,0,3,2864
2,3,5,0,0,0,3,2865
0,0,0,0,0,0,3,2866
3,4,7,0,0,0,3,2867
0,1,1,0,0,0,3,2868
53,261,314,2,3,5,3,2869
1,0,1,0,0,0,3,2870
4,1,5,0,0,0,3,2871
48,39,87,1,2,3,3,2872
1,1,2,0,0,0,3,2873
5,10,15,0,0,0,3,2874
30,13,43,0,0,0,3,2875
2,2,4,0,0,0,3,2876
27,27,54,0,0,0,3,2877
17,7,24,0,0,0,3,2878
71,149,220,2,2,4,3,2879
9,50,59,0,0,0,3,2880
107,79,186,1,0,1,3,2881
44,103,147,0,1,1,3,2882
0,0,0,0,0,0,3,2883
28,17,45,0,0,0,3,2884
238,113,351,4,2,6,3,2885
12,28,40,0,0,0,3,2886
26,42,68,0,3,3,3,2887
86,32,118,5,0,5,3,2888
2151,799,2950,40,9,49,3,2889
33,95,128,0,0,0,3,2890
9,26,35,0,0,0,3,2891
26,81,107,1,0,1,3,2892
35,119,154,2,0,2,3,2893
193,727,920,2,9,11,3,2894
12,6,18,0,0,0,3,2895
0,0,0,0,0,0,3,2896
6,6,12,0,0,0,3,2897
6,15,21,0,1,1,3,2898
3,4,7,0,1,1,3,2899
122,225,347,2,10,12,3,2900
116,89,205,5,0,5,3,2901
10,14,24,0,0,0,3,2902
1,2,3,0,0,0,3,2903
0,3,3,0,0,0,3,2904
10,49,59,0,2,2,3,2905
0,0,0,0,0,0,3,2906
29,101,130,0,2,2,3,2907
4,4,8,0,0,0,3,2908
6,3,9,0,0,0,3,2909
11,52,63,1,0,1,3,2910
0,2,2,0,0,0,3,2911
33,147,180,0,1,1,3,2912
9,5,14,0,1,1,3,2913
6,1,7,0,0,0,3,2914
1,0,1,0,0,0,3,2915
2,0,2,0,0,0,3,2916
24,23,47,0,0,0,3,2917
6,2,8,0,0,0,3,2918
4,4,8,0,0,0,3,2919
2,2,4,0,0,0,3,2920
30,101,131,0,0,0,3,2921
4,3,7,0,0,0,3,2922
1,4,5,0,0,0,3,2923
1,0,1,0,0,0,3,2924
1,7,8,0,0,0,3,2925
16,23,39,0,0,0,3,2926
11,3,14,0,1,1,3,2927
1,6,7,0,0,0,3,2928
734,446,1180,16,3,19,3,2929
67,95,162,2,1,3,3,2930
0,3,3,0,0,0,3,2931
3,8,11,0,0,0,3,2932
165,195,360,1,0,1,3,2933
1,6,7,0,0,0,3,2934
3,0,3,0,0,0,3,2935
831,358,1189,3,1,4,3,2936
6,8,14,0,0,0,3,2937
1,6,7,0,0,0,3,2938
9,0,9,0,0,0,3,2939
37,8,45,0,0,0,3,2940
7,7,14,0,0,0,3,2941
1,1,2,0,0,0,3,2942
4,2,6,0,0,0,3,2943
2,3,5,0,0,0,3,2944
3,2,5,0,0,0,3,2945
194,23,217,1,0,1,3,2946
528,68,596,4,1,5,3,2947
20,2,22,0,0,0,3,2948
3,0,3,0,0,0,3,2949
0,0,0,0,0,0,3,2950
11,1,12,0,0,0,3,2951
141,229,370,9,3,12,3,2952
12,76,88,2,6,8,3,2953
21,11,32,0,1,1,3,2954
47,45,92,1,0,1,3,2955
15,9,24,0,0,0,3,2956
18,14,32,0,0,0,3,2957
0,0,0,0,0,0,3,2958
69,89,158,0,1,1,3,2959
202,249,451,0,4,4,3,2960
9,7,16,0,0,0,3,2961
17,16,33,1,0,1,3,2962
8,5,13,0,1,1,3,2963
9,3,12,0,0,0,3,2964
2,7,9,0,2,2,3,2965
0,1,1,0,0,0,3,2966
0,11,11,0,0,0,3,2967
4,2,6,0,0,0,3,2968
6556,16278,22834,48,136,184,3,2969
0,0,0,0,0,0,3,2970
2,2,4,0,0,0,3,2971
0,2,2,0,1,1,3,2972
1,0,1,0,0,0,3,2973
2,3,5,0,0,0,3,2974
6,18,24,0,0,0,3,2975
8,10,18,0,0,0,3,2976
184,1244,1428,3,5,8,3,2977
2,5,7,0,0,0,3,2978
0,5,5,0,0,0,3,2979
0,1,1,0,0,0,3,2980
1,0,1,0,0,0,3,2981
0,1,1,0,0,0,3,2982
30,50,80,1,0,1,3,2983
12,7,19,0,0,0,3,2984
1,2,3,0,0,0,3,2985
1,11,12,0,0,0,3,2986
35,61,96,1,0,1,3,2987
53,194,247,0,3,3,3,2988
38,184,222,0,0,0,3,2989
0,2,2,0,0,0,3,2990
1,1,2,0,0,0,3,2991
0,2,2,0,0,0,3,2992
52,158,210,3,7,10,3,2993
2,0,2,0,0,0,3,2994
65,38,103,4,0,4,3,2995
0,0,0,0,0,0,3,2996
0,2,2,0,0,0,3,2997
0,1,1,0,0,0,3,2998
1,7,8,0,1,1,3,2999
3,25,28,0,0,0,3,3000
11,3,14,0,0,0,3,3001
83,30,113,3,0,3,3,3002
6,0,6,0,0,0,3,3003
6,4,10,0,0,0,3,3004
14,4,18,0,0,0,3,3005
1314,5368,6682,26,79,105,3,3006
0,0,0,0,0,0,3,3007
1,0,1,0,0,0,3,3008
0,0,0,0,0,0,3,3009
0,0,0,0,0,0,3,3010
1,0,1,0,0,0,3,3011
0,0,0,0,0,0,3,3012
0,0,0,0,0,0,3,3013
2,0,2,0,0,0,3,3014
6,15,21,0,0,0,3,3015
126,260,386,4,3,7,3,3016
3,2,5,0,0,0,3,3017
0,1,1,0,0,0,3,3018
2,5,7,0,0,0,3,3019
1,0,1,0,0,0,3,3020
2,12,14,0,1,1,3,3021
1,1,2,0,0,0,3,3022
13,10,23,0,1,1,3,3023
1,0,1,0,0,0,3,3024
20,21,41,1,0,1,3,3025
7,0,7,0,0,0,3,3026
8,19,27,0,0,0,3,3027
0,2,2,0,0,0,3,3028
2,3,5,0,0,0,3,3029
2,0,2,0,0,0,3,3030
0,2,2,0,0,0,3,3031
2,3,5,0,0,0,3,3032
5,14,19,0,0,0,3,3033
2,8,10,1,0,1,3,3034
1,3,4,0,0,0,3,3035
9,5,14,0,0,0,3,3036
107,43,150,1,0,1,3,3037
129,109,238,0,1,1,3,3038
23,9,32,1,0,1,3,3039
123,310,433,3,6,9,3,3040
96,159,255,1,1,2,3,3041
19,13,32,2,0,2,3,3042
5,11,16,0,0,0,3,3043
216,351,567,7,6,13,3,3044
2,22,24,0,0,0,3,3045
0,0,0,0,0,0,3,3046
0,2,2,0,0,0,3,3047
1,0,1,0,0,0,3,3048
47,60,107,1,0,1,3,3049
146,118,264,7,7,14,3,3050
1,5,6,0,0,0,3,3051
11,4,15,0,0,0,3,3052
0,0,0,0,0,0,3,3053
0,0,0,0,0,0,3,3054
1,0,1,0,0,0,3,3055
6,2,8,0,1,1,3,3056
0,2,2,0,0,0,3,3057
28,15,43,0,0,0,3,3058
1,1,2,0,0,0,3,3059
1,1,2,0,0,0,3,3060
18,9,27,0,0,0,3,3061
15,85,100,0,0,0,3,3062
32,1,33,0,0,0,3,3063
1,0,1,0,0,0,3,3064
16,0,16,0,0,0,3,3065
4,0,4,0,0,0,3,3066
5,0,5,0,0,0,3,3067
1,0,1,0,0,0,3,3068
2,1,3,0,0,0,3,3069
1,2,3,0,0,0,3,3070
45,120,165,1,0,1,3,3071
2,3,5,0,0,0,3,3072
99,136,235,3,5,8,3,3073
22,16,38,0,1,1,3,3074
0,2,2,0,0,0,3,3075
1,0,1,0,0,0,3,3076
1,9,10,0,0,0,3,3077
1,2,3,0,0,0,3,3078
82,69,151,2,1,3,3,3079
0,0,0,0,0,0,3,3080
1,6,7,0,0,0,3,3081
4,22,26,0,1,1,3,3082
11,15,26,1,1,2,3,3083
7,0,7,1,0,1,3,3084
13,11,24,0,0,0,3,3085
10,24,34,1,0,1,3,3086
1,3,4,0,0,0,3,3087
2,0,2,0,0,0,3,3088
1,1,2,0,0,0,3,3089
2,0,2,0,0,0,3,3090
0,1,1,0,0,0,3,3091
3,1,4,0,0,0,3,3092
39,68,107,1,1,2,3,3093
20,16,36,0,0,0,3,3094
112,88,200,2,4,6,3,3095
1,1,2,0,0,0,3,3096
0,0,0,0,0,0,3,3097
7,4,11,0,0,0,3,3098
1,0,1,0,0,0,3,3099
0,0,0,0,0,0,3,3100
1,0,1,0,0,0,3,3101
9,10,19,0,0,0,3,3102
0,6,6,0,0,0,3,3103
5,13,18,0,0,0,3,3104
2,2,4,0,0,0,3,3105
0,0,0,0,0,0,3,3106
0,0,0,0,0,0,3,3107
0,0,0,0,0,0,3,3108
0,0,0,0,0,0,3,3109
0,0,0,0,0,0,3,3110
0,0,0,0,0,0,3,3111
191,365,556,5,20,25,3,3112
7,13,20,0,0,0,3,3113
2,5,7,0,0,0,3,3114
1,2,3,0,0,0,3,3115
0,4,4,0,0,0,3,3116
1,0,1,0,0,0,3,3117
2,0,2,0,0,0,3,3118
8,4,12,0,0,0,3,3119
0,2,2,0,0,0,3,3120
11,48,59,0,0,0,3,3121
28826,48124,76950,331,432,763,3,3122
53,188,241,2,5,7,3,3123
33488,51098,84586,405,311,716,3,3124
440,2336,2776,3,29,32,3,3125
7610,17246,24856,56,75,131,3,3126
49,145,194,0,2,2,3,3127
94,485,579,1,5,6,3,3128
32,85,117,0,0,0,3,3129
10856,29908,40764,42,55,97,3,3130
24,107,131,0,1,1,3,3131
0,1,1,0,0,0,3,3132
0,0,0,0,0,0,3,3133
13,22,35,0,0,0,3,3134
20,35,55,0,2,2,3,3135
78,121,199,4,6,10,3,3136
39,51,90,2,0,2,3,3137
58,156,214,4,12,16,3,3138
14,61,75,0,2,2,3,3139
94,143,237,2,2,4,3,3140
85,179,264,6,6,12,3,3141
87,243,330,2,4,6,3,3142
53,180,233,2,5,7,3,3143
34,92,126,1,2,3,3,3144
94,164,258,0,2,2,3,3145
94,175,269,1,6,7,3,3146
422,710,1132,22,20,42,3,3147
2483,9129,11612,33,59,92,3,3148
11699,43986,55685,113,354,467,3,3149
1,3,4,0,0,0,3,3150
2,1,3,1,0,1,3,3151
3,2,5,0,0,0,3,3152
1,0,1,0,0,0,3,3153
0,1,1,0,0,0,3,3154
1,3,4,0,0,0,3,3155
2,5,7,0,0,0,3,3156
12,18,30,2,2,4,3,3157
0,0,0,0,0,0,3,3158
0,7,7,0,0,0,3,3159
0,3,3,0,1,1,3,3160
2,1,3,0,0,0,3,3161
0,0,0,0,0,0,3,3162
2,5,7,0,0,0,3,3163
0,0,0,0,0,0,3,3164
0,1,1,0,0,0,3,3165
4,4,8,0,0,0,3,3166
6,1,7,0,0,0,3,3167
1,0,1,0,0,0,3,3168
0,6,6,0,0,0,3,3169
5,0,5,0,0,0,3,3170
1,0,1,0,0,0,3,3171
0,0,0,0,0,0,3,3172
27,22,49,0,1,1,3,3173
15,3,18,1,0,1,3,3174
0,1,1,0,0,0,3,3175
4,0,4,0,0,0,3,3176
22,32,54,3,0,3,3,3177
2,1,3,0,0,0,3,3178
18,14,32,0,0,0,3,3179
28,24,52,2,1,3,3,3180
3,3,6,0,0,0,3,3181
74,345,419,1,8,9,3,3182
59,217,276,2,5,7,3,3183
312,178,490,6,0,6,3,3184
21,111,132,0,0,0,3,3185
5,21,26,1,0,1,3,3186
22,85,107,0,6,6,3,3187
0,1,1,0,0,0,3,3188
13,103,116,0,1,1,3,3189
2,10,12,0,0,0,3,3190
2,2,4,0,0,0,3,3191
1,2,3,0,0,0,3,3192
32,15,47,3,0,3,3,3193
19,17,36,1,0,1,3,3194
2,1,3,0,0,0,3,3195
2,0,2,0,0,0,3,3196
2,7,9,0,0,0,3,3197
0,0,0,0,0,0,3,3198
11,20,31,0,0,0,3,3199
0,0,0,0,0,0,3,3200
9,12,21,0,0,0,3,3201
0,1,1,0,0,0,3,3202
0,0,0,0,0,0,3,3203
24,27,51,0,0,0,3,3204
92,86,178,1,1,2,3,3205
80,72,152,4,2,6,3,3206
8,20,28,0,3,3,3,3207
91,155,246,2,6,8,3,3208
7,11,18,0,0,0,3,3209
125,294,419,4,5,9,3,3210
199,400,599,10,19,29,3,3211
103,134,237,1,4,5,3,3212
7,23,30,1,2,3,3,3213
41,116,157,1,0,1,3,3214
67,11,78,1,0,1,3,3215
2,0,2,0,0,0,3,3216
5,16,21,0,1,1,3,3217
0,0,0,0,0,0,3,3218
0,2,2,0,0,0,3,3219
0,0,0,0,0,0,3,3220
7,28,35,0,0,0,3,3221
1,1,2,0,0,0,3,3222
9,20,29,0,0,0,3,3223
1,1,2,0,0,0,3,3224
3,2,5,0,0,0,3,3225
8,14,22,0,0,0,3,3226
1,0,1,0,0,0,3,3227
0,0,0,0,0,0,3,3228
0,1,1,0,0,0,3,3229
0,1,1,0,0,0,3,3230
0,5,5,0,0,0,3,3231
166,472,638,6,18,24,3,3232
2,4,6,0,0,0,3,3233
2,2,4,0,0,0,3,3234
0,0,0,0,0,0,3,3235
3,13,16,0,1,1,3,3236
1,0,1,0,0,0,3,3237
1,2,3,0,0,0,3,3238
0,9,9,0,0,0,3,3239
15,30,45,0,0,0,3,3240
2,7,9,0,0,0,3,3241
13,16,29,1,0,1,3,3242
5,7,12,0,0,0,3,3243
0,0,0,0,0,0,3,3244
2,3,5,0,0,0,3,3245
0,0,0,0,0,0,3,3246
10,1,11,0,0,0,3,3247
3,3,6,0,0,0,3,3248
2,3,5,0,0,0,3,3249
4,0,4,0,0,0,3,3250
1,5,6,1,0,1,3,3251
1,1,2,0,0,0,3,3252
3,0,3,0,0,0,3,3253
0,0,0,0,0,0,3,3254
1,0,1,0,0,0,3,3255
11,6,17,0,0,0,3,3256
14,18,32,0,0,0,3,3257
1,0,1,0,0,0,3,3258
0,0,0,-2,-10,-12,3,3259
0,0,0,-1,-1,-2,3,3260
0,0,0,0,-2,-2,3,3261
0,0,0,0,0,0,3,3262
0,0,0,0,-4,-4,3,3263
0,0,0,-55,-240,-295,3,3264
1,0,1,0,0,0,3,3265
7,19,26,1,1,2,3,3266
15,12,27,0,1,1,3,3267
1,7,8,0,0,0,3,3268
112,778,890,5,33,38,3,3269
119,506,625,1,5,6,3,3270
0,0,0,0,0,0,3,3271
13,49,62,0,1,1,3,3272
28,89,117,1,3,4,3,3273
0,5,5,0,0,0,3,3274
164,235,399,1,4,5,3,3275
8,6,14,0,0,0,3,3276
8,76,84,0,0,0,3,3277
3,10,13,0,0,0,3,3278
0,0,0,0,0,0,3,3279
1,2,3,0,0,0,3,3280
2,0,2,0,0,0,3,3281
1,0,1,0,0,0,3,3282
1,0,1,0,0,0,3,3283
0,0,0,0,0,0,3,3284
2,3,5,0,0,0,3,3285
67,148,215,1,2,3,3,3286
0,0,0,0,0,0,3,3287
0,0,0,0,0,0,3,3288
0,0,0,-2,-5,-7,3,3289
0,0,0,0,-2,-2,3,3290
0,0,0,-2,0,-2,3,3291
0,0,0,-1,-4,-5,3,3292
0,0,0,0,0,0,3,3293
0,0,0,-2,-3,-5,3,3294
0,0,0,0,0,0,3,3295
0,0,0,0,0,0,3,3296
0,0,0,-6,-23,-29,3,3297
0,0,0,-3,0,-3,3,3298
0,1,1,0,0,0,3,3299
1,5,6,0,0,0,3,3300
2,3,5,0,0,0,3,3301
3,5,8,0,0,0,3,3302
5,7,12,0,0,0,3,3303
0,0,0,0,0,0,3,3304
0,0,0,-2,-1,-3,3,3305
0,0,0,-4,-6,-10,3,3306
0,0,0,-1,-6,-7,3,3307
0,0,0,0,-3,-3,3,3308
0,0,0,-1,0,-1,3,3309
0,0,0,-1,-2,-3,3,3310
0,0,0,0,0,0,3,3311
2,0,2,0,0,0,3,3312
28,133,161,0,5,5,3,3313
682,1050,1732,14,22,36,3,3314
28,155,183,1,2,3,3,3315
2,4,6,0,0,0,3,3316
5,7,12,0,0,0,3,3317
93,673,766,3,7,10,3,3318
0,8,8,0,0,0,3,3319
0,0,0,0,0,0,3,3320
0,2,2,0,0,0,3,3321
0,3,3,0,0,0,3,3322
3,14,17,0,1,1,3,3323
26,142,168,1,2,3,3,3324
0,12,12,0,1,1,3,3325
54,136,190,0,3,3,3,3326
88,390,478,1,5,6,3,3327
2967,16677,19644,39,94,133,3,3328
2636,11493,14129,45,131,176,3,3329
248,810,1058,12,15,27,3,3330
74,316,390,2,2,4,3,3331
20,50,70,0,0,0,3,3332
0,0,0,0,0,0,3,3333
3,10,13,0,0,0,3,3334
326,690,1016,9,8,17,3,3335
176,941,1117,2,7,9,3,3336
12,66,78,0,0,0,3,3337
233,729,962,4,2,6,3,3338
5422,14130,19552,72,123,195,3,3339
183,516,699,2,4,6,3,3340
145,456,601,3,22,25,3,3341
867,3353,4220,9,30,39,3,3342
1861,6021,7882,23,27,50,3,3343
3161,18596,21757,42,184,226,3,3344
26,261,287,0,5,5,3,3345
82,187,269,2,4,6,3,3346
0,0,0,0,0,0,3,3347
193,448,641,3,5,8,3,3348
88,163,251,2,1,3,3,3349
61,68,129,1,1,2,3,3350
41,222,263,2,8,10,3,3351
0,0,0,0,0,0,3,3352
5,0,5,0,0,0,3,3353
1,1,2,0,0,0,3,3354
2,0,2,0,0,0,3,3355
0,0,0,0,0,0,3,3356
5,1,6,0,0,0,3,3357
1,0,1,0,0,0,3,3358
1,1,2,0,0,0,3,3359
1,1,2,0,0,0,3,3360
0,0,0,0,0,0,3,3361
29,66,95,2,0,2,3,3362
10,11,21,0,1,1,3,3363
0,0,0,0,0,0,3,3364
435,233,668,4,1,5,3,3365
1,1,2,0,0,0,3,3366
3,2,5,0,1,1,3,3367
9,21,30,0,0,0,3,3368
0,0,0,0,-1,-1,3,3369
0,0,0,0,0,0,3,3370
0,0,0,0,-2,-2,3,3371
0,0,0,0,0,0,3,3372
2,1,3,0,0,0,3,3373
0,0,0,-1,-2,-3,3,3374
1,3,4,0,0,0,3,3375
0,0,0,-1,-6,-7,3,3376
0,0,0,0,-2,-2,3,3377
0,0,0,-2,-2,-4,3,3378
0,0,0,0,0,0,3,3379
0,1,1,0,0,0,3,3380
0,0,0,0,0,0,3,3381
4,0,4,0,0,0,3,3382
0,0,0,0,-1,-1,3,3383
0,0,0,-2,-9,-11,3,3384
8,34,42,0,0,0,3,3385
0,2,2,0,0,0,3,3386
1,18,19,0,0,0,3,3387
0,0,0,0,0,0,3,3388
1,18,19,0,0,0,3,3389
6,2,8,0,0,0,3,3390
5,2,7,0,0,0,3,3391
11,4,15,0,0,0,3,3392
20,4,24,0,0,0,3,3393
15,22,37,0,1,1,3,3394
6,3,9,0,0,0,3,3395
62,33,95,0,0,0,3,3396
0,0,0,0,0,0,3,3397
38,41,79,0,1,1,3,3398
0,1,1,0,0,0,3,3399
0,2,2,0,0,0,3,3400
5,2,7,0,0,0,3,3401
3,1,4,0,0,0,3,3402
2,0,2,0,0,0,3,3403
0,0,0,0,0,0,3,3404
0,4,4,0,0,0,3,3405
3,0,3,0,0,0,3,3406
24,109,133,1,4,5,3,3407
17,56,73,1,1,2,3,3408
30,85,115,0,1,1,3,3409
2,2,4,0,0,0,3,3410
4,16,20,0,0,0,3,3411
13,81,94,0,1,1,3,3412
21,52,73,0,1,1,3,3413
3,10,13,0,0,0,3,3414
23,41,64,0,0,0,3,3415
4,10,14,0,0,0,3,3416
27,98,125,0,3,3,3,3417
501,1841,2342,4,25,29,3,3418
15,28,43,0,0,0,3,3419
0,6,6,0,0,0,3,3420
14,39,53,0,0,0,3,3421
167,367,534,4,14,18,3,3422
11,12,23,0,0,0,3,3423
3,4,7,0,0,0,3,3424
7,8,15,0,0,0,3,3425
8,11,19,0,0,0,3,3426
56,104,160,0,1,1,3,3427
92,173,265,6,2,8,3,3428
50,106,156,0,1,1,3,3429
170,166,336,4,1,5,3,3430
1125,771,1896,21,7,28,3,3431
12,23,35,0,0,0,3,3432
8,10,18,0,0,0,3,3433
2,3,5,0,0,0,3,3434
3,8,11,0,0,0,3,3435
21,48,69,0,0,0,3,3436
91,32,123,2,1,3,3,3437
80,296,376,0,2,2,3,3438
0,0,0,0,0,0,3,3439
0,0,0,-5,-3,-8,3,3440
0,0,0,-2,-2,-4,3,3441
0,0,0,-12,-6,-18,3,3442
3,2,5,0,0,0,3,3443
2875,917,3792,32,8,40,3,3444
122,174,296,3,3,6,3,3445
51,60,111,2,2,4,3,3446
46,160,206,1,2,3,3,3447
955,2657,3612,21,30,51,3,3448
438,1397,1835,6,16,22,3,3449
6,45,51,0,0,0,3,3450
8,71,79,0,1,1,3,3451
2,19,21,0,0,0,3,3452
17,81,98,0,2,2,3,3453
1,0,1,0,0,0,3,3454
14,0,14,0,0,0,3,3455
1,1,2,0,0,0,3,3456
4,14,18,0,0,0,3,3457
2,6,8,0,0,0,3,3458
8504,41260,49764,86,457,543,3,3459
2,0,2,0,0,0,3,3460
2,1,3,0,0,0,3,3461
36,19,55,2,0,2,3,3462
17,10,27,1,1,2,3,3463
13,19,32,1,0,1,3,3464
93,127,220,0,1,1,3,3465
3,70,73,0,1,1,3,3466
1,0,1,0,0,0,3,3467
584,764,1348,10,13,23,3,3468
73,125,198,2,5,7,3,3469
2,0,2,0,0,0,3,3470
16,12,28,0,0,0,3,3471
2,1,3,0,0,0,3,3472
0,2,2,0,0,0,3,3473
0,9,9,0,0,0,3,3474
2,9,11,0,0,0,3,3475
0,6,6,0,0,0,3,3476
0,1,1,0,0,0,3,3477
3,1,4,0,0,0,3,3478
48,81,129,0,2,2,3,3479
289,974,1263,6,15,21,3,3480
31,52,83,0,2,2,3,3481
16,15,31,0,1,1,3,3482
4,12,16,1,0,1,3,3483
5,16,21,1,3,4,3,3484
36,106,142,4,11,15,3,3485
3,11,14,0,0,0,3,3486
4,5,9,0,1,1,3,3487
5,32,37,0,1,1,3,3488
2,2,4,0,0,0,3,3489
1,0,1,0,0,0,3,3490
1,6,7,0,0,0,3,3491
38,31,69,3,2,5,3,3492
5,4,9,0,0,0,3,3493
16,25,41,0,1,1,3,3494
5,24,29,0,0,0,3,3495
1,8,9,0,0,0,3,3496
2,7,9,1,0,1,3,3497
15,69,84,0,0,0,3,3498
5,12,17,0,0,0,3,3499
9,35,44,0,2,2,3,3500
1,1,2,0,0,0,3,3501
4,10,14,0,0,0,3,3502
0,1,1,0,0,0,3,3503
0,0,0,0,0,0,3,3504
369,924,1293,4,39,43,3,3505
111,248,359,1,2,3,3,3506
45,114,159,0,2,2,3,3507
7,30,37,0,0,0,3,3508
0,0,0,0,0,0,3,3509
0,0,0,0,0,0,3,3510
0,0,0,0,0,0,3,3511
63,47,110,0,1,1,3,3512
841,1880,2721,13,37,50,3,3513
76,202,278,0,2,2,3,3514
100,327,427,4,6,10,3,3515
234,1026,1260,4,19,23,3,3516
6,4,10,0,0,0,3,3517
13,19,32,0,0,0,3,3518
0,0,0,0,0,0,3,3519
140,293,433,2,9,11,3,3520
0,0,0,0,0,0,3,3521
0,0,0,0,0,0,3,3522
1,0,1,0,0,0,3,3523
1,0,1,0,0,0,3,3524
2,1,3,0,0,0,3,3525
3,11,14,0,2,2,3,3526
2,2,4,0,0,0,3,3527
0,0,0,0,0,0,3,3528
1,0,1,0,0,0,3,3529
0,3,3,0,0,0,3,3530
0,0,0,0,0,0,3,3531
0,0,0,0,0,0,3,3532
0,0,0,0,0,0,3,3533
7,6,13,1,0,1,3,3534
0,2,2,0,0,0,3,3535
1,5,6,0,0,0,3,3536
1,2,3,0,0,0,3,3537
6,11,17,0,2,2,3,3538
14,43,57,2,2,4,3,3539
90,133,223,1,3,4,3,3540
1,4,5,0,0,0,3,3541
5,8,13,0,0,0,3,3542
13,29,42,0,0,0,3,3543
1,0,1,0,0,0,3,3544
0,0,0,0,0,0,3,3545
976,1786,2762,18,37,55,3,3546
39,169,208,0,4,4,3,3547
15,104,119,1,0,1,3,3548
1,0,1,0,0,0,3,3549
5,0,5,0,0,0,3,3550
18,24,42,0,0,0,3,3551
6,0,6,0,0,0,3,3552
2,1,3,0,0,0,3,3553
1,3,4,0,0,0,3,3554
0,2,2,0,0,0,3,3555
110,113,223,2,2,4,3,3556
1,3,4,0,0,0,3,3557
12,34,46,0,0,0,3,3558
2,9,11,0,0,0,3,3559
5,0,5,0,0,0,3,3560
5,1,6,0,0,0,3,3561
9,28,37,1,0,1,3,3562
9,60,69,0,2,2,3,3563
0,0,0,0,0,0,3,3564
27,71,98,3,3,6,3,3565
2,1,3,0,0,0,3,3566
7,47,54,0,1,1,3,3567
89,420,509,3,14,17,3,3568
11,24,35,0,0,0,3,3569
1,2,3,0,0,0,3,3570
1,3,4,0,0,0,3,3571
2,1,3,0,0,0,3,3572
6,5,11,1,0,1,3,3573
9,10,19,0,0,0,3,3574
0,0,0,0,0,0,3,3575
0,1,1,0,0,0,3,3576
4,2,6,0,0,0,3,3577
7,30,37,0,0,0,3,3578
218,679,897,5,4,9,3,3579
41,106,147,0,2,2,3,3580
186,277,463,2,4,6,3,3581
4702,16458,21160,17,37,54,3,3582
1440,5195,6635,9,54,63,3,3583
53,203,256,1,4,5,3,3584
36,103,139,0,0,0,3,3585
2288,7413,9701,25,69,94,3,3586
2093,7405,9498,17,34,51,3,3587
1670,7303,8973,8,35,43,3,3588
4,3,7,0,0,0,3,3589
3,0,3,0,0,0,3,3590
1,1,2,0,0,0,3,3591
0,0,0,0,0,0,3,3592
5,33,38,0,0,0,3,3593
2,1,3,0,0,0,3,3594
0,2,2,0,0,0,3,3595
1,0,1,0,0,0,3,3596
3,2,5,0,0,0,3,3597
1,1,2,0,0,0,3,3598
0,0,0,0,0,0,3,3599
1,2,3,0,0,0,3,3600
26,37,63,0,0,0,3,3601
0,0,0,0,0,0,3,3602
40,108,148,2,5,7,3,3603
33,66,99,1,4,5,3,3604
1825,15863,17688,18,39,57,3,3605
16410,47214,63624,160,291,451,3,3606
59,192,251,0,2,2,3,3607
98,397,495,3,3,6,3,3608
23,138,161,0,2,2,3,3609
254,1093,1347,1,6,7,3,3610
834,2275,3109,39,82,121,3,3611
362,968,1330,4,7,11,3,3612
20,61,81,0,1,1,3,3613
33,111,144,4,3,7,3,3614
1003,3850,4853,20,52,72,3,3615
6,1,7,1,0,1,3,3616
3,3,6,0,0,0,3,3617
267,108,375,4,0,4,3,3618
56,35,91,1,0,1,3,3619
2,15,17,0,0,0,3,3620
0,18,18,0,0,0,3,3621
3,8,11,0,0,0,3,3622
2,9,11,0,0,0,3,3623
434,713,1147,9,8,17,3,3624
399,1111,1510,4,14,18,3,3625
0,10,10,0,0,0,3,3626
75,28,103,1,0,1,3,3627
41,50,91,1,1,2,3,3628
213,60,273,3,2,5,3,3629
0,0,0,0,0,0,3,3630
65,16,81,2,0,2,3,3631
13,0,13,0,0,0,3,3632
2,1,3,0,0,0,3,3633
5,7,12,0,0,0,3,3634
7,21,28,0,0,0,3,3635
0,3,3,0,0,0,3,3636
1,0,1,0,0,0,3,3637
0,0,0,0,0,0,3,3638
0,2,2,0,0,0,3,3639
1,3,4,0,0,0,3,3640
0,2,2,0,0,0,3,3641
0,2,2,0,0,0,3,3642
5,4,9,0,1,1,3,3643
0,0,0,0,0,0,3,3644
4,1,5,0,0,0,3,3645
1,0,1,0,0,0,3,3646
1,1,2,0,0,0,3,3647
2,6,8,0,0,0,3,3648
0,0,0,0,0,0,3,3649
1,6,7,0,0,0,3,3650
1,1,2,1,0,1,3,3651
2,6,8,0,0,0,3,3652
7,21,28,1,0,1,3,3653
3,1,4,0,0,0,3,3654
0,0,0,0,0,0,3,3655
0,2,2,0,0,0,3,3656
2,5,7,0,0,0,3,3657
0,0,0,0,0,0,3,3658
9,13,22,0,0,0,3,3659
22,53,75,0,1,1,3,3660
28,69,97,0,2,2,3,3661
23,32,55,1,1,2,3,3662
55,121,176,0,0,0,3,3663
1,8,9,0,0,0,3,3664
2,27,29,0,0,0,3,3665
8,27,35,0,0,0,3,3666
0,0,0,0,0,0,3,3667
0,0,0,0,0,0,3,3668
1,1,2,0,0,0,3,3669
64,138,202,1,0,1,3,3670
468,2041,2509,2,6,8,3,3671
27,22,49,0,0,0,3,3672
9,9,18,0,0,0,3,3673
4,0,4,1,0,1,3,3674
43,176,219,0,1,1,3,3675
10,13,23,0,0,0,3,3676
13,60,73,0,0,0,3,3677
10,29,39,0,0,0,3,3678
3,4,7,0,0,0,3,3679
0,0,0,0,0,0,3,3680
3,17,20,0,0,0,3,3681
0,1,1,0,0,0,3,3682
0,0,0,0,0,0,3,3683
1,1,2,0,0,0,3,3684
0,0,0,0,0,0,3,3685
0,0,0,0,0,0,3,3686
493,1617,2110,10,6,16,3,3687
898,2876,3774,13,16,29,3,3688
112,209,321,1,0,1,3,3689
163,364,527,3,3,6,3,3690
192,221,413,6,3,9,3,3691
461,2527,2988,1,28,29,3,3692
6,13,19,0,0,0,3,3693
2,12,14,0,0,0,3,3694
1,1,2,0,0,0,3,3695
1,0,1,0,0,0,3,3696
0,0,0,0,0,0,3,3697
1,0,1,0,0,0,3,3698
0,0,0,0,0,0,3,3699
0,0,0,0,0,0,3,3700
4,7,11,0,0,0,3,3701
2,3,5,0,0,0,3,3702
16,11,27,0,0,0,3,3703
92,184,276,4,7,11,3,3704
4,2,6,0,0,0,3,3705
4,6,10,0,0,0,3,3706
27,17,44,0,0,0,3,3707
131,224,355,8,16,24,3,3708
0,1,1,0,0,0,3,3709
406,1538,1944,4,11,15,3,3710
11,10,21,0,3,3,3,3711
8,3,11,1,0,1,3,3712
148,407,555,3,2,5,3,3713
5,27,32,0,0,0,3,3714
0,0,0,0,0,0,3,3715
17,11,28,0,0,0,3,3716
8,3,11,0,0,0,3,3717
0,0,0,0,0,0,3,3718
408,1419,1827,5,32,37,3,3719
31,122,153,0,0,0,3,3720
36,174,210,0,1,1,3,3721
7,36,43,0,1,1,3,3722
22,85,107,0,2,2,3,3723
0,1,1,0,0,0,3,3724
1,0,1,0,0,0,3,3725
0,0,0,0,0,0,3,3726
49,26,75,0,0,0,3,3727
35,55,90,0,0,0,3,3728
138,1365,1503,0,8,8,3,3729
7,13,20,0,0,0,3,3730
4,1,5,0,0,0,3,3731
17,19,36,0,0,0,3,3732
13,15,28,0,1,1,3,3733
2,19,21,0,0,0,3,3734
0,3,3,0,0,0,3,3735
0,1,1,0,0,0,3,3736
3,7,10,0,0,0,3,3737
0,1,1,0,0,0,3,3738
1,0,1,0,0,0,3,3739
0,0,0,0,0,0,3,3740
2,12,14,0,0,0,3,3741
0,0,0,0,0,0,3,3742
1,0,1,0,0,0,3,3743
1,0,1,0,0,0,3,3744
189,466,655,6,14,20,3,3745
223,697,920,6,15,21,3,3746
6,6,12,0,1,1,3,3747
511,1735,2246,8,21,29,3,3748
1,0,1,0,0,0,3,3749
1,5,6,0,0,0,3,3750
3,11,14,0,1,1,3,3751
17,6,23,1,2,3,3,3752
0,11,11,0,0,0,3,3753
1,2,3,0,0,0,3,3754
0,3,3,0,0,0,3,3755
0,0,0,0,0,0,3,3756
0,0,0,0,0,0,3,3757
0,0,0,0,0,0,3,3758
0,1,1,0,0,0,3,3759
0,0,0,0,0,0,3,3760
7,14,21,0,0,0,3,3761
0,0,0,0,0,0,3,3762
0,4,4,0,0,0,3,3763
16,45,61,0,0,0,3,3764
9,2,11,0,0,0,3,3765
1,0,1,0,0,0,3,3766
0,2,2,0,0,0,3,3767
0,0,0,-2,0,-2,3,3768
5,16,21,0,0,0,3,3769
0,0,0,0,0,0,3,3770
0,1,1,0,0,0,3,3771
0,0,0,0,0,0,3,3772
0,0,0,0,0,0,3,3773
48,53,101,6,4,10,3,3774
27,15,42,1,1,2,3,3775
1,0,1,0,0,0,3,3776
0,0,0,0,0,0,3,3777
0,0,0,0,0,0,3,3778
0,0,0,0,0,0,3,3779
25,19,44,1,1,2,3,3780
0,0,0,0,0,0,3,3781
2,0,2,0,0,0,3,3782
6,4,10,0,0,0,3,3783
477,166,643,9,2,11,3,3784
0,0,0,0,0,0,3,3785
0,1,1,0,0,0,3,3786
74,25,99,2,0,2,3,3787
16,9,25,0,0,0,3,3788
5,3,8,0,0,0,3,3789
1,1,2,0,0,0,3,3790
0,0,0,0,0,0,3,3791
0,0,0,0,0,0,3,3792
0,0,0,0,0,0,3,3793
7,2,9,0,0,0,3,3794
0,0,0,0,0,0,3,3795
1,0,1,0,0,0,3,3796
1,0,1,0,0,0,3,3797
0,0,0,0,0,0,3,3798
1,3,4,0,0,0,3,3799
2,0,2,0,0,0,3,3800
1,0,1,0,0,0,3,3801
0,0,0,0,0,0,3,3802
0,0,0,0,0,0,3,3803
1,0,1,0,0,0,3,3804
1,0,1,0,0,0,3,3805
1,0,1,0,0,0,3,3806
3,26,29,0,2,2,3,3807
0,0,0,0,0,0,3,3808
1,5,6,0,1,1,3,3809
0,2,2,0,0,0,3,3810
3,2,5,0,0,0,3,3811
0,0,0,0,0,0,3,3812
0,1,1,0,0,0,3,3813
0,1,1,0,0,0,3,3814
1,10,11,0,0,0,3,3815
0,0,0,0,0,0,3,3816
0,0,0,0,0,0,3,3817
0,0,0,0,0,0,3,3818
0,0,0,0,0,0,3,3819
0,0,0,0,0,0,3,3820
0,0,0,0,0,0,3,3821
0,0,0,0,0,0,3,3822
0,0,0,0,0,0,3,3823
0,0,0,0,0,0,3,3824
0,3,3,0,1,1,3,3825
0,1,1,0,0,0,3,3826
0,3,3,0,0,0,3,3827
31,139,170,0,2,2,3,3828
42,70,112,1,0,1,3,3829
7,11,18,0,0,0,3,3830
9,9,18,0,0,0,3,3831
10,28,38,0,0,0,3,3832
0,4,4,0,0,0,3,3833
10,10,20,0,0,0,3,3834
0,0,0,0,0,0,3,3835
133,345,478,7,9,16,3,3836
3,8,11,0,1,1,3,3837
4,5,9,0,0,0,3,3838
0,0,0,0,0,0,3,3839
0,5,5,0,0,0,3,3840
2,1,3,0,0,0,3,3841
821,3956,4777,10,49,59,3,3842
42,89,131,1,2,3,3,3843
2,1,3,0,0,0,3,3844
0,0,0,0,0,0,3,3845
0,0,0,0,0,0,3,3846
1,0,1,0,0,0,3,3847
2,5,7,0,0,0,3,3848
0,0,0,0,0,0,3,3849
0,0,0,0,0,0,3,3850
1,1,2,0,1,1,3,3851
0,0,0,0,0,0,3,3852
1,0,1,0,0,0,3,3853
0,0,0,0,0,0,3,3854
4,13,17,0,0,0,3,3855
2,0,2,0,0,0,3,3856
0,1,1,0,0,0,3,3857
2,0,2,0,0,0,3,3858
0,0,0,0,0,0,3,3859
14,9,23,0,0,0,3,3860
0,4,4,0,1,1,3,3861
2,4,6,0,0,0,3,3862
5,6,11,0,0,0,3,3863
11,2,13,0,0,0,3,3864
1,1,2,0,1,1,3,3865
81,37,118,1,0,1,3,3866
44,120,164,0,0,0,3,3867
2,5,7,0,0,0,3,3868
0,2,2,0,0,0,3,3869
3,2,5,0,0,0,3,3870
0,0,0,0,0,0,3,3871
1,1,2,0,0,0,3,3872
0,7,7,0,1,1,3,3873
7,2,9,0,0,0,3,3874
8,9,17,0,0,0,3,3875
2,3,5,0,0,0,3,3876
2,1,3,0,0,0,3,3877
0,1,1,0,0,0,3,3878
0,0,0,0,0,0,3,3879
3,5,8,0,0,0,3,3880
1,6,7,0,0,0,3,3881
1,1,2,0,0,0,3,3882
0,1,1,0,0,0,3,3883
3,1,4,1,0,1,3,3884
0,0,0,0,0,0,3,3885
0,4,4,0,0,0,3,3886
1,1,2,0,0,0,3,3887
39,20,59,3,2,5,3,3888
2,1,3,0,0,0,3,3889
10,8,18,0,0,0,3,3890
3,9,12,0,0,0,3,3891
0,0,0,0,0,0,3,3892
1,1,2,0,0,0,3,3893
1,2,3,0,0,0,3,3894
0,0,0,0,0,0,3,3895
3,20,23,0,1,1,3,3896
0,0,0,0,0,0,3,3897
3,7,10,0,0,0,3,3898
1,3,4,0,0,0,3,3899
2,1,3,0,0,0,3,3900
6,1,7,0,0,0,3,3901
7,1,8,1,0,1,3,3902
13,42,55,0,0,0,3,3903
2,13,15,0,1,1,3,3904
0,0,0,0,0,0,3,3905
0,2,2,0,0,0,3,3906
0,0,0,0,0,0,3,3907
0,0,0,0,0,0,3,3908
0,0,0,0,0,0,3,3909
4,4,8,0,0,0,3,3910
0,2,2,0,0,0,3,3911
9,5,14,1,0,1,3,3912
5,1,6,0,0,0,3,3913
2,2,4,0,0,0,3,3914
3,3,6,0,0,0,3,3915
2,0,2,0,0,0,3,3916
1,0,1,0,0,0,3,3917
0,0,0,0,0,0,3,3918
0,0,0,0,0,0,3,3919
0,0,0,0,0,0,3,3920
0,0,0,0,0,0,3,3921
12,18,30,0,0,0,3,3922
0,0,0,0,0,0,3,3923
2,0,2,0,0,0,3,3924
0,0,0,0,0,0,3,3925
0,0,0,0,0,0,3,3926
16,11,27,0,0,0,3,3927
10,12,22,0,3,3,3,3928
1,3,4,0,0,0,3,3929
0,0,0,0,0,0,3,3930
0,0,0,0,0,0,3,3931
1,1,2,0,0,0,3,3932
124,350,474,6,18,24,3,3933
2,4,6,0,1,1,3,3934
0,0,0,0,0,0,3,3935
1,2,3,0,0,0,3,3936
1,1,2,1,0,1,3,3937
0,0,0,0,0,0,3,3938
0,0,0,0,0,0,3,3939
0,0,0,0,0,0,3,3940
1,0,1,0,0,0,3,3941
12,29,41,0,1,1,3,3942
0,0,0,0,0,0,3,3943
1,0,1,0,0,0,3,3944
4,0,4,0,0,0,3,3945
9,5,14,2,0,2,3,3946
0,0,0,0,0,0,3,3947
1,0,1,0,0,0,3,3948
1,1,2,0,0,0,3,3949
4,0,4,0,0,0,3,3950
71,205,276,2,9,11,3,3951
0,0,0,0,0,0,3,3952
0,0,0,-1,-1,-2,3,3953
1,0,1,0,0,0,3,3954
2,2,4,0,0,0,3,3955
4,7,11,0,0,0,3,3956
0,0,0,0,0,0,3,3957
0,0,0,0,0,0,3,3958
8,32,40,0,0,0,3,3959
5,5,10,1,0,1,3,3960
1,0,1,0,0,0,3,3961
6,3,9,0,0,0,3,3962
0,0,0,0,0,0,3,3963
0,0,0,0,0,0,3,3964
6,4,10,0,0,0,3,3965
0,0,0,0,0,0,3,3966
0,0,0,0,0,0,3,3967
1,2,3,0,0,0,3,3968
8,1,9,1,0,1,3,3969
13,7,20,0,0,0,3,3970
10,3,13,0,0,0,3,3971
1,0,1,0,0,0,3,3972
0,0,0,0,0,0,3,3973
1,0,1,0,0,0,3,3974
2,0,2,0,0,0,3,3975
2,1,3,0,0,0,3,3976
2,2,4,0,0,0,3,3977
9,3,12,0,0,0,3,3978
0,0,0,0,0,0,3,3979
0,0,0,0,0,0,3,3980
0,0,0,0,0,0,3,3981
1,3,4,0,0,0,3,3982
0,0,0,0,0,0,3,3983
0,1,1,0,0,0,3,3984
1,2,3,0,0,0,3,3985
0,0,0,0,0,0,3,3986
0,0,0,0,0,0,3,3987
0,0,0,0,0,0,3,3988
7,65,72,1,3,4,3,3989
4,1,5,0,0,0,3,3990
0,0,0,0,0,0,3,3991
3,1,4,0,0,0,3,3992
0,0,0,0,0,0,3,3993
0,0,0,0,0,0,3,3994
6,0,6,0,0,0,3,3995
12,68,80,0,0,0,3,3996
2,23,25,0,0,0,3,3997
0,2,2,0,0,0,3,3998
0,0,0,0,0,0,3,3999
3,0,3,0,0,0,3,4000
2,1,3,0,0,0,3,4001
2,7,9,0,0,0,3,4002
0,1,1,0,0,0,3,4003
1,0,1,0,0,0,3,4004
0,0,0,0,0,0,3,4005
0,1,1,0,0,0,3,4006
99,288,387,2,7,9,3,4007
1,0,1,0,0,0,3,4008
1,4,5,0,0,0,3,4009
1,2,3,0,0,0,3,4010
0,0,0,0,0,0,3,4011
1,0,1,0,0,0,3,4012
2,2,4,0,0,0,3,4013
0,1,1,0,0,0,3,4014
0,0,0,0,0,0,3,4015
1,0,1,0,0,0,3,4016
1,1,2,0,0,0,3,4017
28,41,69,1,0,1,3,4018
18,47,65,1,0,1,3,4019
5,11,16,1,0,1,3,4020
3,1,4,0,0,0,3,4021
1,4,5,0,1,1,3,4022
8,29,37,1,1,2,3,4023
0,0,0,0,0,0,3,4024
1,1,2,0,0,0,3,4025
0,0,0,0,0,0,3,4026
1,12,13,0,1,1,3,4027
3,0,3,0,0,0,3,4028
1,1,2,0,0,0,3,4029
0,0,0,0,0,0,3,4030
0,2,2,0,0,0,3,4031
1,0,1,0,0,0,3,4032
0,0,0,0,0,0,3,4033
8,2,10,0,0,0,3,4034
28,151,179,2,7,9,3,4035
0,0,0,0,0,0,3,4036
0,1,1,0,0,0,3,4037
0,0,0,0,0,0,3,4038
0,0,0,0,0,0,3,4039
0,0,0,0,0,0,3,4040
0,0,0,0,0,0,3,4041
0,6,6,0,0,0,3,4042
1,1,2,0,0,0,3,4043
5,14,19,0,0,0,3,4044
0,0,0,0,0,0,3,4045
4,7,11,0,0,0,3,4046
8,12,20,0,1,1,3,4047
0,0,0,0,0,0,3,4048
4,0,4,0,0,0,3,4049
1,2,3,0,0,0,3,4050
30,6,36,1,0,1,3,4051
0,0,0,0,0,0,3,4052
1,0,1,0,0,0,3,4053
1,0,1,0,0,0,3,4054
0,0,0,0,0,0,3,4055
0,1,1,0,0,0,3,4056
0,0,0,0,0,0,3,4057
0,0,0,0,0,0,3,4058
1,1,2,0,0,0,3,4059
70,69,139,1,1,2,3,4060
5561,6175,11736,60,47,107,3,4061
657,1879,2536,8,25,33,3,4062
0,0,0,0,0,0,3,4063
0,0,0,0,0,0,3,4064
0,1,1,0,0,0,3,4065
0,0,0,0,0,0,3,4066
6,3,9,0,0,0,3,4067
56,26,82,2,0,2,3,4068
0,0,0,0,0,0,3,4069
1,1,2,0,0,0,3,4070
0,1,1,0,1,1,3,4071
731,2315,3046,23,35,58,3,4072
1,1,2,0,0,0,3,4073
145,125,270,4,1,5,3,4074
75,46,121,5,1,6,3,4075
3,4,7,0,0,0,3,4076
406,301,707,11,7,18,3,4077
0,0,0,0,0,0,3,4078
0,0,0,0,0,0,3,4079
8,6,14,0,0,0,3,4080
3,2,5,0,0,0,3,4081
3,3,6,0,0,0,3,4082
2,6,8,0,0,0,3,4083
0,0,0,0,0,0,3,4084
10,4,14,0,0,0,3,4085
8,6,14,0,1,1,3,4086
47,136,183,2,2,4,3,4087
5,50,55,0,0,0,3,4088
0,0,0,0,0,0,3,4089
11,6,17,1,0,1,3,4090
10,1,11,0,0,0,3,4091
5,1,6,0,0,0,3,4092
0,0,0,0,0,0,3,4093
0,0,0,0,0,0,3,4094
6,22,28,0,1,1,3,4095
18,48,66,0,2,2,3,4096
0,0,0,0,0,0,3,4097
1,2,3,0,0,0,3,4098
4,2,6,0,0,0,3,4099
2,0,2,0,0,0,3,4100
0,0,0,0,0,0,3,4101
0,1,1,0,0,0,3,4102
0,0,0,0,0,0,3,4103
0,0,0,0,0,0,3,4104
0,0,0,0,0,0,3,4105
0,0,0,0,0,0,3,4106
0,0,0,0,0,0,3,4107
0,0,0,0,0,0,3,4108
0,1,1,0,0,0,3,4109
2,1,3,0,0,0,3,4110
0,2,2,0,0,0,3,4111
0,0,0,0,0,0,3,4112
0,0,0,0,0,0,3,4113
6,2,8,1,0,1,3,4114
0,0,0,0,0,0,3,4115
0,0,0,0,0,0,3,4116
8,12,20,1,1,2,3,4117
0,0,0,0,0,0,3,4118
1,1,2,0,0,0,3,4119
3,4,7,0,0,0,3,4120
0,0,0,0,0,0,3,4121
2,1,3,0,0,0,3,4122
0,1,1,0,0,0,3,4123
1,1,2,0,0,0,3,4124
0,0,0,0,0,0,3,4125
2,1,3,0,0,0,3,4126
0,0,0,0,0,0,3,4127
0,0,0,0,0,0,3,4128
1,0,1,0,0,0,3,4129
0,0,0,0,0,0,3,4130
0,0,0,0,0,0,3,4131
1,0,1,0,0,0,3,4132
0,0,0,0,0,0,3,4133
2,3,5,0,0,0,3,4134
1,0,1,0,0,0,3,4135
0,0,0,0,0,0,3,4136
1,1,2,0,0,0,3,4137
18,49,67,1,2,3,3,4138
0,0,0,0,0,0,3,4139
0,0,0,0,0,0,3,4140
1,0,1,0,0,0,3,4141
0,0,0,0,0,0,3,4142
0,0,0,0,0,0,3,4143
3,1,4,0,0,0,3,4144
32,71,103,1,2,3,3,4145
3,12,15,0,1,1,3,4146
0,1,1,0,0,0,3,4147
0,0,0,0,0,0,3,4148
0,0,0,0,0,0,3,4149
1,2,3,0,0,0,3,4150
0,0,0,0,0,0,3,4151
3,0,3,0,0,0,3,4152
10,10,20,1,0,1,3,4153
0,0,0,0,0,0,3,4154
0,0,0,0,0,0,3,4155
0,0,0,0,0,0,3,4156
0,0,0,0,0,0,3,4157
1,0,1,0,0,0,3,4158
5,10,15,0,2,2,3,4159
1,2,3,0,0,0,3,4160
67,310,377,1,2,3,3,4161
3,3,6,0,0,0,3,4162
0,0,0,0,0,0,3,4163
0,0,0,0,0,0,3,4164
1,0,1,0,0,0,3,4165
25,6,31,2,0,2,3,4166
0,0,0,0,0,0,3,4167
0,0,0,0,0,0,3,4168
0,0,0,0,0,0,3,4169
0,0,0,0,0,0,3,4170
1,1,2,0,0,0,3,4171
0,0,0,0,0,0,3,4172
0,0,0,0,0,0,3,4173
0,0,0,0,0,0,3,4174
0,1,1,0,0,0,3,4175
0,0,0,0,0,0,3,4176
0,0,0,0,0,0,3,4177
0,0,0,0,0,0,3,4178
0,0,0,0,0,0,3,4179
0,0,0,0,0,0,3,4180
0,0,0,0,0,0,3,4181
2,2,4,0,0,0,3,4182
6,2,8,1,0,1,3,4183
0,0,0,0,0,0,3,4184
0,1,1,0,0,0,3,4185
16,42,58,0,1,1,3,4186
0,1,1,0,0,0,3,4187
3,0,3,0,0,0,3,4188
1,0,1,0,0,0,3,4189
3,0,3,0,0,0,3,4190
0,0,0,0,0,0,3,4191
0,0,0,0,0,0,3,4192
0,1,1,0,0,0,3,4193
4,0,4,1,0,1,3,4194
5,1,6,1,0,1,3,4195
16,22,38,0,1,1,3,4196
0,0,0,0,0,0,3,4197
1,0,1,0,0,0,3,4198
158,481,639,4,7,11,3,4199
2,2,4,0,0,0,3,4200
0,0,0,0,0,0,3,4201
0,0,0,0,0,0,3,4202
0,0,0,0,0,0,3,4203
0,0,0,0,0,0,3,4204
0,1,1,0,0,0,3,4205
0,0,0,0,0,0,3,4206
2,0,2,0,0,0,3,4207
0,0,0,0,0,0,3,4208
0,1,1,0,0,0,3,4209
0,1,1,0,0,0,3,4210
0,0,0,0,0,0,3,4211
0,0,0,0,0,0,3,4212
0,2,2,0,0,0,3,4213
0,0,0,0,0,0,3,4214
1,0,1,0,0,0,3,4215
0,0,0,0,0,0,3,4216
7,5,12,0,0,0,3,4217
0,4,4,0,0,0,3,4218
4,13,17,0,0,0,3,4219
4,10,14,0,0,0,3,4220
3,2,5,0,0,0,3,4221
0,0,0,0,0,0,3,4222
13,137,150,1,0,1,3,4223
0,1,1,0,0,0,3,4224
4,5,9,0,0,0,3,4225
1,2,3,0,0,0,3,4226
0,4,4,0,0,0,3,4227
19,9,28,0,0,0,3,4228
0,0,0,0,0,0,3,4229
5,5,10,0,0,0,3,4230
24,31,55,3,2,5,3,4231
2,0,2,0,0,0,3,4232
0,0,0,0,0,0,3,4233
0,0,0,0,0,0,3,4234
90,384,474,2,11,13,3,4235
0,3,3,0,0,0,3,4236
0,0,0,0,0,0,3,4237
0,0,0,0,0,0,3,4238
0,0,0,0,0,0,3,4239
1,2,3,0,0,0,3,4240
3,0,3,0,0,0,3,4241
5,0,5,0,0,0,3,4242
4,1,5,0,0,0,3,4243
3,3,6,0,0,0,3,4244
11,32,43,1,1,2,3,4245
95,187,282,6,4,10,3,4246
1,2,3,0,0,0,3,4247
19,17,36,0,0,0,3,4248
1,0,1,0,0,0,3,4249
1,0,1,0,0,0,3,4250
1,0,1,0,0,0,3,4251
2,0,2,0,0,0,3,4252
0,0,0,0,0,0,3,4253
0,0,0,0,0,0,3,4254
0,0,0,0,0,0,3,4255
1,0,1,0,0,0,3,4256
18,4,22,1,0,1,3,4257
0,0,0,0,0,0,3,4258
0,0,0,0,0,0,3,4259
1,1,2,0,0,0,3,4260
5,0,5,2,0,2,3,4261
9,4,13,1,0,1,3,4262
16,7,23,2,1,3,3,4263
3,9,12,0,0,0,3,4264
118,648,766,5,6,11,3,4265
1,0,1,0,0,0,3,4266
0,0,0,0,0,0,3,4267
0,0,0,0,0,0,3,4268
8,2,10,0,0,0,3,4269
0,1,1,0,0,0,3,4270
2,1,3,0,0,0,3,4271
61,82,143,0,3,3,3,4272
5,22,27,0,0,0,3,4273
6,0,6,0,0,0,3,4274
0,1,1,0,0,0,3,4275
0,0,0,0,0,0,3,4276
1,1,2,1,0,1,3,4277
0,0,0,0,0,0,3,4278
4,20,24,0,1,1,3,4279
1,1,2,0,0,0,3,4280
0,2,2,0,0,0,3,4281
0,0,0,0,0,0,3,4282
0,0,0,0,0,0,3,4283
20,29,49,1,0,1,3,4284
1,1,2,0,0,0,3,4285
4,1,5,0,0,0,3,4286
0,0,0,0,0,0,3,4287
0,0,0,0,0,0,3,4288
0,0,0,0,0,0,3,4289
1,0,1,0,0,0,3,4290
7,13,20,0,1,1,3,4291
1,1,2,0,0,0,3,4292
56,26,82,0,0,0,3,4293
5,2,7,0,0,0,3,4294
13,56,69,0,2,2,3,4295
5,0,5,0,0,0,3,4296
4,3,7,0,0,0,3,4297
0,1,1,0,0,0,3,4298
313,51,364,6,0,6,3,4299
1,0,1,0,0,0,3,4300
3,26,29,0,0,0,3,4301
1,0,1,0,0,0,3,4302
1,6,7,0,0,0,3,4303
86,139,225,1,2,3,3,4304
7,32,39,0,0,0,3,4305
11,6,17,1,0,1,3,4306
0,0,0,0,0,0,3,4307
0,1,1,0,0,0,3,4308
6,6,12,0,0,0,3,4309
1,6,7,0,0,0,3,4310
1,3,4,0,0,0,3,4311
4,9,13,0,0,0,3,4312
1,1,2,0,0,0,3,4313
1,0,1,0,0,0,3,4314
233,167,400,10,2,12,3,4315
1,2,3,0,0,0,3,4316
14,14,28,0,1,1,3,4317
5,15,20,0,0,0,3,4318
0,0,0,0,0,0,3,4319
0,0,0,0,0,0,3,4320
7,1,8,0,0,0,3,4321
3,6,9,0,0,0,3,4322
10,2,12,0,0,0,3,4323
3,4,7,0,0,0,3,4324
13,11,24,0,1,1,3,4325
1,8,9,0,0,0,3,4326
9,9,18,0,1,1,3,4327
1,0,1,0,0,0,3,4328
24,90,114,0,6,6,3,4329
15,11,26,0,0,0,3,4330
6,13,19,1,1,2,3,4331
1,6,7,0,0,0,3,4332
5,21,26,0,3,3,3,4333
0,0,0,0,0,0,3,4334
0,0,0,0,0,0,3,4335
1,1,2,0,0,0,3,4336
6,0,6,0,0,0,3,4337
2,0,2,0,0,0,3,4338
1,0,1,0,0,0,3,4339
0,2,2,0,0,0,3,4340
21,16,37,0,0,0,3,4341
0,0,0,0,0,0,3,4342
4,0,4,0,0,0,3,4343
0,0,0,0,0,0,3,4344
2,0,2,0,0,0,3,4345
1,0,1,0,0,0,3,4346
0,0,0,0,0,0,3,4347
0,0,0,0,0,0,3,4348
0,0,0,0,0,0,3,4349
449,571,1020,2,1,3,3,4350
0,0,0,0,0,0,3,4351
3,2,5,0,0,0,3,4352
3,4,7,0,0,0,3,4353
1,0,1,0,0,0,3,4354
0,0,0,0,0,0,3,4355
3,6,9,0,0,0,3,4356
5,18,23,0,1,1,3,4357
0,3,3,0,0,0,3,4358
7,1,8,2,0,2,3,4359
9,20,29,1,1,2,3,4360
1,1,2,0,0,0,3,4361
1,1,2,0,0,0,3,4362
0,1,1,0,0,0,3,4363
0,1,1,0,0,0,3,4364
0,1,1,0,0,0,3,4365
0,0,0,0,0,0,3,4366
0,0,0,0,0,0,3,4367
0,0,0,0,0,0,3,4368
0,0,0,0,0,0,3,4369
0,0,0,0,0,0,3,4370
0,1,1,0,0,0,3,4371
0,0,0,0,0,0,3,4372
0,0,0,0,0,0,3,4373
1,0,1,0,0,0,3,4374
2,0,2,0,0,0,3,4375
0,1,1,0,1,1,3,4376
1,2,3,0,0,0,3,4377
3,0,3,0,0,0,3,4378
6,2,8,0,0,0,3,4379
4,1,5,0,0,0,3,4380
0,0,0,0,0,0,3,4381
0,6,6,0,0,0,3,4382
1,0,1,0,0,0,3,4383
5,13,18,0,0,0,3,4384
16,6,22,0,0,0,3,4385
12,5,17,0,0,0,3,4386
0,0,0,0,0,0,3,4387
0,0,0,0,0,0,3,4388
9,5,14,0,0,0,3,4389
2,7,9,0,0,0,3,4390
9,21,30,0,1,1,3,4391
7,38,45,0,2,2,3,4392
1,0,1,0,0,0,3,4393
2,2,4,0,0,0,3,4394
0,2,2,0,0,0,3,4395
0,0,0,0,0,0,3,4396
8,6,14,2,0,2,3,4397
1,0,1,0,0,0,3,4398
5,20,25,0,0,0,3,4399
13,23,36,0,0,0,3,4400
0,0,0,0,0,0,3,4401
2,2,4,0,0,0,3,4402
2,0,2,0,0,0,3,4403
17,5,22,1,1,2,3,4404
85,389,474,0,0,0,3,4405
94,298,392,3,13,16,3,4406
20,4,24,2,0,2,3,4407
17,20,37,0,0,0,3,4408
4,5,9,1,0,1,3,4409
5,0,5,0,0,0,3,4410
1,0,1,0,0,0,3,4411
0,0,0,0,0,0,3,4412
1,2,3,0,0,0,3,4413
0,0,0,0,0,0,3,4414
0,9,9,0,0,0,3,4415
1,1,2,0,0,0,3,4416
0,1,1,0,0,0,3,4417
1,0,1,0,0,0,3,4418
1,1,2,0,0,0,3,4419
0,0,0,0,0,0,3,4420
0,1,1,0,0,0,3,4421
13,36,49,0,0,0,3,4422
3,1,4,0,0,0,3,4423
1,1,2,0,0,0,3,4424
0,8,8,0,0,0,3,4425
7,4,11,0,0,0,3,4426
3,1,4,0,0,0,3,4427
0,0,0,0,0,0,3,4428
0,1,1,0,0,0,3,4429
0,1,1,0,0,0,3,4430
2,1,3,0,0,0,3,4431
14,0,14,0,0,0,3,4432
2,1,3,0,0,0,3,4433
7,1,8,0,0,0,3,4434
2,4,6,0,0,0,3,4435
3,3,6,0,0,0,3,4436
0,0,0,0,0,0,3,4437
5,4,9,0,0,0,3,4438
4,0,4,0,0,0,3,4439
2,4,6,0,0,0,3,4440
4,3,7,0,0,0,3,4441
14,24,38,1,1,2,3,4442
2,0,2,0,0,0,3,4443
1,0,1,0,0,0,3,4444
1,1,2,0,0,0,3,4445
2,0,2,0,0,0,3,4446
0,0,0,0,0,0,3,4447
1,1,2,0,0,0,3,4448
0,0,0,0,0,0,3,4449
0,2,2,0,0,0,3,4450
0,0,0,0,0,0,3,4451
3,0,3,0,0,0,3,4452
2780,2588,5368,175,154,329,3,4453
2210,1527,3737,116,81,197,3,4454
4,1,5,0,0,0,3,4455
5,1,6,0,0,0,3,4456
7,66,73,1,11,12,3,4457
0,2,2,0,0,0,3,4458
2,0,2,0,0,0,3,4459
9,1,10,1,0,1,3,4460
9,9,18,1,0,1,3,4461
6,2,8,0,0,0,3,4462
0,0,0,0,0,0,3,4463
1,0,1,0,0,0,3,4464
4,3,7,0,0,0,3,4465
4,0,4,0,0,0,3,4466
4,1,5,0,0,0,3,4467
3,0,3,1,0,1,3,4468
2,0,2,0,0,0,3,4469
0,0,0,0,0,0,3,4470
2,0,2,0,0,0,3,4471
2,0,2,0,0,0,3,4472
4,3,7,0,0,0,3,4473
0,0,0,0,0,0,3,4474
18177,12744,30921,149,120,269,3,4475
0,0,0,0,0,0,3,4476
0,2,2,0,0,0,3,4477
1,1,2,0,0,0,3,4478
36,13,49,3,0,3,3,4479
13,6,19,1,1,2,3,4480
16,14,30,2,2,4,3,4481
1,0,1,0,0,0,3,4482
0,0,0,0,0,0,3,4483
0,1,1,0,0,0,3,4484
5,1,6,0,0,0,3,4485
0,0,0,0,0,0,3,4486
2,1,3,0,0,0,3,4487
10,51,61,0,2,2,3,4488
2,0,2,0,0,0,3,4489
4,3,7,0,0,0,3,4490
2,1,3,0,0,0,3,4491
0,0,0,0,0,0,3,4492
20,13,33,0,0,0,3,4493
17,13,30,1,0,1,3,4494
2,2,4,0,0,0,3,4495
0,4,4,0,0,0,3,4496
1,1,2,0,0,0,3,4497
1,0,1,0,0,0,3,4498
2,0,2,0,0,0,3,4499
15,12,27,1,0,1,3,4500
0,0,0,0,0,0,3,4501
0,0,0,0,0,0,3,4502
11,12,23,1,0,1,3,4503
0,0,0,0,0,0,3,4504
1,0,1,0,0,0,3,4505
3,1,4,0,0,0,3,4506
20,4,24,1,0,1,3,4507
1,0,1,0,0,0,3,4508
1,1,2,0,0,0,3,4509
0,2,2,0,0,0,3,4510
0,1,1,0,1,1,3,4511
18,6,24,0,0,0,3,4512
4,6,10,0,0,0,3,4513
4,0,4,1,0,1,3,4514
1,0,1,0,0,0,3,4515
3,0,3,1,0,1,3,4516
1,2,3,0,0,0,3,4517
9,6,15,1,0,1,3,4518
3,2,5,0,0,0,3,4519
0,2,2,0,0,0,3,4520
0,0,0,0,0,0,3,4521
1,0,1,0,0,0,3,4522
0,3,3,0,0,0,3,4523
0,2,2,0,0,0,3,4524
2,0,2,0,0,0,3,4525
5,3,8,0,0,0,3,4526
1,0,1,0,0,0,3,4527
0,0,0,0,0,0,3,4528
0,0,0,0,0,0,3,4529
2,5,7,0,0,0,3,4530
1,1,2,0,0,0,3,4531
0,0,0,0,0,0,3,4532
2,1,3,0,0,0,3,4533
0,0,0,0,0,0,3,4534
1,1,2,0,0,0,3,4535
0,2,2,0,0,0,3,4536
2,0,2,0,0,0,3,4537
1,0,1,0,0,0,3,4538
1,3,4,0,0,0,3,4539
0,3,3,0,0,0,3,4540
0,0,0,0,0,0,3,4541
6,0,6,0,0,0,3,4542
7,1,8,0,0,0,3,4543
0,0,0,0,0,0,3,4544
0,0,0,0,0,0,3,4545
221,123,344,1,0,1,3,4546
1,0,1,0,0,0,3,4547
40,76,116,3,7,10,3,4548
1,8,9,0,0,0,3,4549
5,34,39,0,0,0,3,4550
0,0,0,0,0,0,3,4551
0,0,0,0,0,0,3,4552
0,2,2,0,0,0,3,4553
25,43,68,1,2,3,3,4554
26,31,57,1,0,1,3,4555
2,0,2,0,0,0,3,4556
0,0,0,0,0,0,3,4557
0,0,0,0,0,0,3,4558
0,4,4,0,0,0,3,4559
0,0,0,0,0,0,3,4560
0,2,2,0,0,0,3,4561
0,0,0,0,0,0,3,4562
1,0,1,0,0,0,3,4563
0,2,2,0,0,0,3,4564
0,0,0,0,0,0,3,4565
0,6,6,0,0,0,3,4566
1,1,2,0,0,0,3,4567
0,1,1,0,1,1,3,4568
0,5,5,0,0,0,3,4569
1,0,1,0,0,0,3,4570
2,2,4,0,0,0,3,4571
3,0,3,0,0,0,3,4572
0,1,1,0,0,0,3,4573
0,0,0,0,0,0,3,4574
0,0,0,0,0,0,3,4575
6,1,7,0,0,0,3,4576
1,0,1,0,0,0,3,4577
4,2,6,0,0,0,3,4578
1,3,4,0,0,0,3,4579
0,0,0,0,0,0,3,4580
1,0,1,0,0,0,3,4581
1,0,1,0,0,0,3,4582
0,0,0,0,0,0,3,4583
0,0,0,0,0,0,3,4584
0,0,0,0,0,0,3,4585
0,0,0,0,0,0,3,4586
0,0,0,0,0,0,3,4587
1,0,1,0,0,0,3,4588
0,3,3,0,0,0,3,4589
7,2,9,0,1,1,3,4590
0,0,0,0,0,0,3,4591
1,3,4,0,0,0,3,4592
0,1,1,0,0,0,3,4593
1,4,5,0,0,0,3,4594
7,9,16,0,0,0,3,4595
716,366,1082,35,29,64,3,4596
2266,1704,3970,104,91,195,3,4597
90,44,134,3,2,5,3,4598
21,47,68,4,2,6,3,4599
4,12,16,0,1,1,3,4600
2,1,3,0,0,0,3,4601
1,0,1,0,0,0,3,4602
12,4,16,0,0,0,3,4603
5,8,13,0,0,0,3,4604
2,0,2,0,0,0,3,4605
1,2,3,0,0,0,3,4606
2,0,2,0,0,0,3,4607
5,3,8,1,0,1,3,4608
7,2,9,0,0,0,3,4609
2,2,4,0,0,0,3,4610
2,0,2,0,0,0,3,4611
0,1,1,0,0,0,3,4612
0,2,2,0,0,0,3,4613
22,6,28,0,1,1,3,4614
7,2,9,0,0,0,3,4615
0,1,1,0,0,0,3,4616
2,2,4,1,1,2,3,4617
0,0,0,0,0,0,3,4618
1,1,2,0,0,0,3,4619
3,11,14,0,0,0,3,4620
2,11,13,0,0,0,3,4621
3,11,14,0,0,0,3,4622
17,61,78,1,0,1,3,4623
1,0,1,0,0,0,3,4624
3,4,7,0,0,0,3,4625
2,6,8,1,0,1,3,4626
1,3,4,0,0,0,3,4627
33,43,76,2,1,3,3,4628
6,0,6,0,0,0,3,4629
7,6,13,1,1,2,3,4630
2,0,2,0,0,0,3,4631
2,0,2,0,0,0,3,4632
1,0,1,0,0,0,3,4633
17,22,39,0,0,0,3,4634
26,64,90,1,1,2,3,4635
1,0,1,0,0,0,3,4636
2,8,10,0,1,1,3,4637
0,3,3,0,0,0,3,4638
3,16,19,1,0,1,3,4639
8,12,20,0,0,0,3,4640
7,8,15,0,1,1,3,4641
0,0,0,0,0,0,3,4642
0,4,4,0,0,0,3,4643
0,0,0,0,0,0,3,4644
0,1,1,0,0,0,3,4645
0,0,0,0,0,0,3,4646
1,0,1,1,0,1,3,4647
6,3,9,0,0,0,3,4648
5,12,17,2,1,3,3,4649
2,0,2,0,0,0,3,4650
2,4,6,0,0,0,3,4651
5,30,35,0,0,0,3,4652
1,1,2,0,0,0,3,4653
1,0,1,0,0,0,3,4654
0,1,1,0,0,0,3,4655
0,0,0,0,0,0,3,4656
93,258,351,2,2,4,3,4657
0,1,1,0,0,0,3,4658
3,4,7,0,0,0,3,4659
2,2,4,0,0,0,3,4660
3,0,3,0,0,0,3,4661
0,2,2,0,0,0,3,4662
4,6,10,0,0,0,3,4663
17,125,142,0,0,0,3,4664
3,1,4,0,0,0,3,4665
142,46,188,8,3,11,3,4666
101,98,199,2,9,11,3,4667
1,4,5,0,0,0,3,4668
0,0,0,0,0,0,3,4669
7,25,32,1,3,4,3,4670
31,10,41,3,0,3,3,4671
0,4,4,0,0,0,3,4672
0,0,0,0,0,0,3,4673
4,0,4,0,0,0,3,4674
0,0,0,0,0,0,3,4675
2,2,4,1,1,2,3,4676
0,0,0,0,0,0,3,4677
0,0,0,0,0,0,3,4678
0,0,0,0,0,0,3,4679
1,2,3,0,0,0,3,4680
1,0,1,0,0,0,3,4681
2,0,2,0,0,0,3,4682
0,0,0,0,0,0,3,4683
0,0,0,0,0,0,3,4684
130,179,309,0,1,1,3,4685
195,181,376,1,0,1,3,4686
33,11,44,2,0,2,3,4687
1,6,7,0,0,0,3,4688
1,0,1,0,0,0,3,4689
4,1,5,0,0,0,3,4690
2,5,7,0,0,0,3,4691
1,0,1,1,0,1,3,4692
11,30,41,0,0,0,3,4693
1,0,1,0,0,0,3,4694
0,0,0,0,0,0,3,4695
0,0,0,0,0,0,3,4696
4,5,9,0,0,0,3,4697
3,0,3,0,0,0,3,4698
3,0,3,0,0,0,3,4699
6,4,10,0,0,0,3,4700
10,12,22,0,2,2,3,4701
7,2,9,0,0,0,3,4702
1,0,1,0,0,0,3,4703
0,0,0,0,0,0,3,4704
89,110,199,3,9,12,3,4705
2,7,9,0,0,0,3,4706
8,1,9,0,0,0,3,4707
0,0,0,0,0,0,3,4708
3,1,4,1,0,1,3,4709
3,19,22,0,3,3,3,4710
3,0,3,1,0,1,3,4711
1,0,1,0,0,0,3,4712
3,1,4,0,1,1,3,4713
0,0,0,0,0,0,3,4714
1,2,3,0,0,0,3,4715
16,25,41,1,4,5,3,4716
2,0,2,0,0,0,3,4717
3,0,3,0,0,0,3,4718
0,0,0,0,0,0,3,4719
0,0,0,0,0,0,3,4720
0,0,0,0,0,0,3,4721
4,2,6,0,0,0,3,4722
3,0,3,0,0,0,3,4723
0,0,0,0,0,0,3,4724
0,0,0,0,0,0,3,4725
0,1,1,0,1,1,3,4726
0,0,0,0,0,0,3,4727
2,4,6,0,0,0,3,4728
1,0,1,0,0,0,3,4729
0,0,0,0,0,0,3,4730
0,0,0,0,0,0,3,4731
0,0,0,0,0,0,3,4732
0,0,0,0,0,0,3,4733
0,0,0,0,0,0,3,4734
0,0,0,0,0,0,3,4735
2,1,3,0,0,0,3,4736
1,1,2,0,0,0,3,4737
0,0,0,0,0,0,3,4738
1,0,1,0,0,0,3,4739
0,0,0,0,0,0,3,4740
1,2,3,0,0,0,3,4741
0,0,0,0,0,0,3,4742
0,0,0,0,0,0,3,4743
0,0,0,0,0,0,3,4744
1,0,1,0,0,0,3,4745
6,1,7,0,0,0,3,4746
1,1,2,0,0,0,3,4747
0,3,3,0,0,0,3,4748
1,0,1,0,0,0,3,4749
0,0,0,0,0,0,3,4750
0,0,0,0,0,0,3,4751
1,2,3,1,1,2,3,4752
0,0,0,0,0,0,3,4753
0,0,0,0,0,0,3,4754
1,0,1,0,0,0,3,4755
8,5,13,1,0,1,3,4756
0,0,0,0,0,0,3,4757
0,0,0,0,0,0,3,4758
0,0,0,0,0,0,3,4759
0,0,0,0,0,0,3,4760
1,4,5,0,1,1,3,4761
0,0,0,0,0,0,3,4762
0,0,0,0,0,0,3,4763
0,0,0,0,0,0,3,4764
1,1,2,0,0,0,3,4765
0,0,0,0,0,0,3,4766
0,0,0,0,0,0,3,4767
0,1,1,0,0,0,3,4768
0,0,0,0,0,0,3,4769
0,0,0,0,0,0,3,4770
0,0,0,0,0,0,3,4771
2,3,5,0,0,0,3,4772
0,0,0,0,0,0,3,4773
1,0,1,1,0,1,3,4774
2,0,2,2,0,2,3,4775
0,0,0,0,0,0,3,4776
0,0,0,0,0,0,3,4777
2,0,2,0,0,0,3,4778
0,0,0,0,0,0,3,4779
0,1,1,0,0,0,3,4780
1,0,1,0,0,0,3,4781
2,2,4,0,1,1,3,4782
0,0,0,0,0,0,3,4783
0,0,0,0,0,0,3,4784
0,1,1,0,0,0,3,4785
0,0,0,0,0,0,3,4786
0,0,0,0,0,0,3,4787
0,0,0,0,0,0,3,4788
0,0,0,0,0,0,3,4789
1,0,1,0,0,0,3,4790
1,2,3,0,0,0,3,4791
0,1,1,0,0,0,3,4792
2,3,5,1,0,1,3,4793
0,0,0,0,0,0,3,4794
0,0,0,0,0,0,3,4795
0,0,0,0,0,0,3,4796
1,0,1,0,0,0,3,4797
1,10,11,0,2,2,3,4798
0,0,0,0,0,0,3,4799
6,3,9,0,0,0,3,4800
0,0,0,0,0,0,3,4801
3,10,13,0,0,0,3,4802
0,1,1,0,0,0,3,4803
0,0,0,0,0,0,3,4804
2,2,4,1,0,1,3,4805
1,0,1,0,0,0,3,4806
0,0,0,0,0,0,3,4807
12,8,20,0,1,1,3,4808
25,14,39,0,1,1,3,4809
0,1,1,0,1,1,3,4810
0,7,7,0,0,0,3,4811
0,0,0,0,0,0,3,4812
1,0,1,0,0,0,3,4813
0,0,0,0,0,0,3,4814
18,2,20,3,2,5,3,4815
0,0,0,0,0,0,3,4816
53,2,55,1,0,1,3,4817
3,1,4,0,0,0,3,4818
0,0,0,0,0,0,3,4819
2,0,2,1,0,1,3,4820
2,0,2,1,0,1,3,4821
0,0,0,0,0,0,3,4822
0,0,0,0,0,0,3,4823
0,0,0,0,0,0,3,4824
4,3,7,1,0,1,3,4825
7,7,14,1,0,1,3,4826
2,2,4,0,0,0,3,4827
0,0,0,0,0,0,3,4828
0,0,0,0,0,0,3,4829
330,200,530,34,26,60,3,4830
0,0,0,0,0,0,3,4831
123,274,397,14,17,31,3,4832
0,0,0,0,0,0,3,4833
0,0,0,0,0,0,3,4834
1,0,1,0,0,0,3,4835
0,0,0,0,0,0,3,4836
0,0,0,0,0,0,3,4837
11,14,25,2,0,2,3,4838
8,12,20,1,3,4,3,4839
0,0,0,0,0,0,3,4840
2,1,3,1,0,1,3,4841
0,1,1,0,0,0,3,4842
1,0,1,0,0,0,3,4843
2,1,3,0,0,0,3,4844
0,0,0,0,0,0,3,4845
0,0,0,0,0,0,3,4846
0,0,0,0,0,0,3,4847
0,0,0,0,0,0,3,4848
0,0,0,0,0,0,3,4849
0,0,0,0,0,0,3,4850
0,2,2,0,0,0,3,4851
0,4,4,0,0,0,3,4852
1,0,1,0,0,0,3,4853
0,1,1,0,0,0,3,4854
0,1,1,0,0,0,3,4855
0,1,1,0,1,1,3,4856
0,0,0,0,0,0,3,4857
0,0,0,0,0,0,3,4858
2,0,2,1,0,1,3,4859
0,0,0,0,0,0,3,4860
0,0,0,0,0,0,3,4861
0,1,1,0,1,1,3,4862
0,0,0,0,0,0,3,4863
0,0,0,0,0,0,3,4864
0,1,1,0,1,1,3,4865
1,0,1,0,0,0,3,4866
1,0,1,0,0,0,3,4867
0,0,0,0,0,0,3,4868
0,0,0,0,0,0,3,4869
0,0,0,0,0,0,3,4870
0,0,0,0,0,0,3,4871
0,0,0,0,0,0,3,4872
1,0,1,0,0,0,3,4873
0,0,0,0,0,0,3,4874
3,0,3,0,0,0,3,4875
0,0,0,0,0,0,3,4876
0,0,0,0,0,0,3,4877
0,0,0,0,0,0,3,4878
8,3,11,0,0,0,3,4879
0,4,4,0,0,0,3,4880
0,2,2,0,1,1,3,4881
2,0,2,0,0,0,3,4882
9,23,32,0,5,5,3,4883
0,0,0,0,0,0,3,4884
0,1,1,0,0,0,3,4885
0,0,0,0,0,0,3,4886
2,0,2,2,0,2,3,4887
0,0,0,0,0,0,3,4888
0,0,0,0,0,0,3,4889
0,0,0,0,0,0,3,4890
1,0,1,0,0,0,3,4891
0,0,0,0,0,0,3,4892
0,0,0,0,0,0,3,4893
0,0,0,0,0,0,3,4894
0,0,0,0,0,0,3,4895
0,0,0,0,0,0,3,4896
2,1,3,0,1,1,3,4897
0,0,0,0,0,0,3,4898
0,2,2,0,0,0,3,4899
0,0,0,0,0,0,3,4900
1,0,1,1,0,1,3,4901
4,7,11,2,1,3,3,4902
4,5,9,1,2,3,3,4903
2,0,2,0,0,0,3,4904
1,0,1,0,0,0,3,4905
0,0,0,0,0,0,3,4906
2,2,4,1,0,1,3,4907
0,0,0,0,0,0,3,4908
2,1,3,0,1,1,3,4909
1,2,3,0,0,0,3,4910
1,1,2,1,0,1,3,4911
3,1,4,0,1,1,3,4912
0,1,1,0,0,0,3,4913
0,0,0,0,0,0,3,4914
0,0,0,0,0,0,3,4915
0,0,0,0,0,0,3,4916
0,0,0,0,0,0,3,4917
0,0,0,0,0,0,3,4918
0,0,0,0,0,0,3,4919
0,0,0,0,0,0,3,4920
0,0,0,0,0,0,3,4921
0,0,0,0,0,0,3,4922
5,2,7,0,1,1,3,4923
1,0,1,0,0,0,3,4924
0,1,1,0,1,1,3,4925
0,0,0,0,0,0,3,4926
0,0,0,0,0,0,3,4927
0,0,0,0,0,0,3,4928
0,0,0,0,0,0,3,4929
0,0,0,0,0,0,3,4930
0,0,0,0,0,0,3,4931
0,0,0,0,0,0,3,4932
0,0,0,0,0,0,3,4933
0,0,0,0,0,0,3,4934
0,0,0,0,0,0,3,4935
0,0,0,0,0,0,3,4936
0,0,0,0,0,0,3,4937
0,0,0,0,0,0,3,4938
0,0,0,0,0,0,3,4939
0,0,0,0,0,0,3,4940
0,0,0,0,0,0,3,4941
0,0,0,0,0,0,3,4942
0,0,0,0,0,0,3,4943
0,0,0,0,0,0,3,4944
0,0,0,0,0,0,3,4945
0,0,0,0,0,0,3,4946
1,0,1,0,0,0,3,4947
2861,589,3450,30,7,37,4,1
9,1,10,0,0,0,4,2
8,3,11,0,0,0,4,3
87,32,119,1,0,1,4,4
99,48,147,0,0,0,4,5
21,21,42,1,1,2,4,6
24,13,37,0,0,0,4,7
123,37,160,1,0,1,4,8
18,3,21,0,0,0,4,9
15,3,18,0,0,0,4,10
688,370,1058,2,1,3,4,11
209,109,318,0,0,0,4,12
1350,1432,2782,11,13,24,4,13
2097,1198,3295,12,8,20,4,14
5668,6102,11770,52,70,122,4,15
2766,1506,4272,24,14,38,4,16
6117,4457,10574,17,19,36,4,17
2928,1589,4517,18,4,22,4,18
2090,1571,3661,11,10,21,4,19
49800,32118,81918,167,136,303,4,20
24845,12851,37696,145,105,250,4,21
26819,13727,40546,269,157,426,4,22
886,1218,2104,5,8,13,4,23
976,206,1182,0,0,0,4,24
27,16,43,0,0,0,4,25
18,9,27,0,0,0,4,26
450,916,1366,3,4,7,4,27
38,10,48,0,0,0,4,28
38,49,87,0,0,0,4,29
47,49,96,0,2,2,4,30
316,206,522,2,0,2,4,31
8,4,12,0,0,0,4,32
13,3,16,0,0,0,4,33
18,16,34,0,0,0,4,34
161,376,537,0,0,0,4,35
108,51,159,1,0,1,4,36
2987,1233,4220,13,15,28,4,37
23,6,29,0,0,0,4,38
502,322,824,1,2,3,4,39
348,121,469,1,1,2,4,40
40,11,51,0,0,0,4,41
1577,1822,3399,2,4,6,4,42
17,0,17,0,0,0,4,43
5,2,7,0,0,0,4,44
48,20,68,2,0,2,4,45
124,52,176,1,0,1,4,46
17,11,28,0,0,0,4,47
19206,9419,28625,99,44,143,4,48
1312,932,2244,16,4,20,4,49
8,13,21,0,0,0,4,50
17,23,40,1,1,2,4,51
64,42,106,0,0,0,4,52
208,84,292,2,0,2,4,53
243,200,443,0,0,0,4,54
81,143,224,1,0,1,4,55
116,147,263,0,2,2,4,56
241,420,661,1,0,1,4,57
494,241,735,1,0,1,4,58
692,253,945,0,1,1,4,59
282,236,518,1,0,1,4,60
628,534,1162,3,5,8,4,61
472,267,739,6,1,7,4,62
163,57,220,0,0,0,4,63
15,6,21,0,0,0,4,64
16,13,29,0,0,0,4,65
265,251,516,2,2,4,4,66
5172,3375,8547,15,13,28,4,67
6457,10163,16620,14,21,35,4,68
25,5,30,1,0,1,4,69
5,3,8,0,0,0,4,70
42,6,48,0,0,0,4,71
1,6,7,0,0,0,4,72
605,1020,1625,3,12,15,4,73
22,3,25,0,0,0,4,74
139,161,300,3,1,4,4,75
73,314,387,0,2,2,4,76
326,205,531,3,3,6,4,77
109,242,351,0,1,1,4,78
41,56,97,0,1,1,4,79
6,2,8,0,0,0,4,80
52,11,63,1,0,1,4,81
3,1,4,0,0,0,4,82
9,2,11,0,0,0,4,83
5,4,9,0,0,0,4,84
1,3,4,0,0,0,4,85
0,0,0,0,0,0,4,86
4,2,6,0,0,0,4,87
6,6,12,0,0,0,4,88
60,47,107,0,0,0,4,89
62,25,87,1,0,1,4,90
83,45,128,0,0,0,4,91
30,15,45,0,0,0,4,92
8,2,10,0,0,0,4,93
63,54,117,0,0,0,4,94
17,9,26,0,0,0,4,95
23,30,53,0,0,0,4,96
5,3,8,0,0,0,4,97
7,1,8,0,0,0,4,98
0,3,3,0,0,0,4,99
128229,41230,169459,151,70,221,4,100
234,31,265,0,0,0,4,101
27,9,36,0,0,0,4,102
5,3,8,0,0,0,4,103
15,4,19,0,1,1,4,104
52,9,61,0,0,0,4,105
514,324,838,1,1,2,4,106
108,82,190,0,0,0,4,107
180,54,234,1,0,1,4,108
166,92,258,3,0,3,4,109
243,396,639,3,2,5,4,110
2,5,7,0,0,0,4,111
72,15,87,0,0,0,4,112
79,92,171,0,0,0,4,113
41,45,86,0,0,0,4,114
56,16,72,0,0,0,4,115
16,16,32,0,0,0,4,116
5,2,7,0,1,1,4,117
39,20,59,0,0,0,4,118
3,2,5,0,0,0,4,119
1,2,3,0,0,0,4,120
3,4,7,0,0,0,4,121
7,18,25,0,2,2,4,122
1774,429,2203,17,4,21,4,123
836,1140,1976,7,7,14,4,124
16,20,36,0,0,0,4,125
485,1017,1502,4,0,4,4,126
78,78,156,1,2,3,4,127
587,839,1426,3,8,11,4,128
13,6,19,0,0,0,4,129
13,5,18,0,0,0,4,130
117,74,191,0,0,0,4,131
19,17,36,0,0,0,4,132
105,58,163,3,0,3,4,133
24591,25466,50057,52,77,129,4,134
90,69,159,1,0,1,4,135
347,160,507,1,3,4,4,136
12,9,21,0,0,0,4,137
7,9,16,1,0,1,4,138
339,107,446,3,1,4,4,139
60,75,135,1,1,2,4,140
31,5,36,0,0,0,4,141
11,42,53,0,0,0,4,142
132,28,160,0,0,0,4,143
38,7,45,1,0,1,4,144
115,74,189,1,1,2,4,145
183,152,335,0,2,2,4,146
26859,26646,53505,209,163,372,4,147
24,22,46,0,0,0,4,148
32,60,92,0,0,0,4,149
20,14,34,0,0,0,4,150
55,14,69,0,0,0,4,151
339,223,562,6,4,10,4,152
27,6,33,0,0,0,4,153
70,38,108,1,0,1,4,154
6,3,9,0,0,0,4,155
58,2,60,0,0,0,4,156
39,76,115,0,0,0,4,157
1013,731,1744,3,0,3,4,158
27,5,32,0,0,0,4,159
58,12,70,0,0,0,4,160
369,545,914,2,3,5,4,161
56,13,69,0,0,0,4,162
3,6,9,0,0,0,4,163
7,4,11,0,0,0,4,164
6,9,15,0,0,0,4,165
2,5,7,0,0,0,4,166
15,6,21,0,0,0,4,167
7,7,14,0,0,0,4,168
144,233,377,0,0,0,4,169
18,28,46,1,0,1,4,170
43,154,197,0,0,0,4,171
13,6,19,0,0,0,4,172
25,4,29,0,0,0,4,173
22,8,30,0,0,0,4,174
115,173,288,0,1,1,4,175
44,19,63,0,0,0,4,176
100,47,147,0,0,0,4,177
10,37,47,0,0,0,4,178
32,35,67,0,0,0,4,179
530,1111,1641,0,6,6,4,180
119,174,293,2,0,2,4,181
164,181,345,0,1,1,4,182
13,6,19,0,0,0,4,183
1251,4750,6001,10,27,37,4,184
39,154,193,0,1,1,4,185
338,46,384,3,2,5,4,186
301,25,326,2,0,2,4,187
66,112,178,0,2,2,4,188
95,37,132,1,1,2,4,189
69,39,108,2,1,3,4,190
16,10,26,1,0,1,4,191
141,52,193,0,0,0,4,192
917,1691,2608,0,3,3,4,193
32,9,41,0,0,0,4,194
15,6,21,0,1,1,4,195
41,6,47,0,0,0,4,196
8,2,10,0,0,0,4,197
18,6,24,0,0,0,4,198
22,12,34,0,0,0,4,199
76,19,95,0,0,0,4,200
12934,13948,26882,48,32,80,4,201
17,6,23,0,0,0,4,202
42,14,56,0,0,0,4,203
9,0,9,0,0,0,4,204
404,376,780,0,0,0,4,205
38,68,106,0,0,0,4,206
35,14,49,1,1,2,4,207
3559,853,4412,14,11,25,4,208
14,4,18,0,0,0,4,209
3,0,3,0,0,0,4,210
46,17,63,0,0,0,4,211
52,57,109,0,0,0,4,212
22,5,27,0,0,0,4,213
41,13,54,0,1,1,4,214
9,16,25,1,0,1,4,215
13,7,20,0,0,0,4,216
13,7,20,0,0,0,4,217
10,5,15,0,0,0,4,218
17,0,17,0,0,0,4,219
11,8,19,0,0,0,4,220
63,250,313,0,3,3,4,221
85,41,126,1,0,1,4,222
439,130,569,5,0,5,4,223
197,85,282,1,1,2,4,224
10,5,15,0,0,0,4,225
9,1,10,0,0,0,4,226
10,9,19,0,0,0,4,227
209,37,246,0,1,1,4,228
570,23,593,1,0,1,4,229
163,28,191,1,0,1,4,230
175,15,190,0,0,0,4,231
9,0,9,0,0,0,4,232
113,83,196,2,1,3,4,233
15,6,21,0,0,0,4,234
41,16,57,0,0,0,4,235
170,943,1113,2,7,9,4,236
298,323,621,0,2,2,4,237
48,360,408,0,2,2,4,238
30,124,154,0,0,0,4,239
24,124,148,0,1,1,4,240
54,30,84,0,0,0,4,241
109,135,244,1,0,1,4,242
4,3,7,0,0,0,4,243
55,13,68,0,0,0,4,244
39,31,70,2,0,2,4,245
5,4,9,0,0,0,4,246
3,0,3,0,0,0,4,247
24,5,29,0,0,0,4,248
4,3,7,0,0,0,4,249
8,15,23,0,0,0,4,250
6,4,10,0,0,0,4,251
16,13,29,0,0,0,4,252
5,10,15,0,0,0,4,253
2,14,16,0,0,0,4,254
4,1,5,0,0,0,4,255
2,1,3,0,0,0,4,256
5,0,5,0,0,0,4,257
3,3,6,0,0,0,4,258
1,0,1,0,0,0,4,259
1,2,3,0,0,0,4,260
1,1,2,0,0,0,4,261
17,18,35,0,0,0,4,262
223,179,402,2,0,2,4,263
33,15,48,0,0,0,4,264
88,50,138,0,0,0,4,265
22,29,51,0,0,0,4,266
19,6,25,0,0,0,4,267
3,4,7,0,0,0,4,268
1,2,3,0,0,0,4,269
5,1,6,0,0,0,4,270
4,3,7,0,0,0,4,271
44,10,54,0,0,0,4,272
5,5,10,0,0,0,4,273
27,7,34,0,0,0,4,274
4,0,4,0,0,0,4,275
1,1,2,0,0,0,4,276
6,0,6,1,0,1,4,277
2,0,2,0,0,0,4,278
5,0,5,0,0,0,4,279
0,0,0,0,0,0,4,280
22,11,33,1,0,1,4,281
54,53,107,0,1,1,4,282
204,256,460,7,6,13,4,283
53,141,194,1,0,1,4,284
30,19,49,0,0,0,4,285
21,12,33,0,1,1,4,286
6,10,16,0,0,0,4,287
35,38,73,0,0,0,4,288
6,10,16,0,0,0,4,289
1178,369,1547,3,0,3,4,290
14,7,21,0,0,0,4,291
13,3,16,0,0,0,4,292
163,47,210,1,0,1,4,293
8,8,16,0,0,0,4,294
59,22,81,0,0,0,4,295
14,9,23,0,0,0,4,296
26,25,51,0,0,0,4,297
11,14,25,0,0,0,4,298
5,5,10,0,0,0,4,299
8,16,24,0,0,0,4,300
8,9,17,0,0,0,4,301
15,16,31,0,1,1,4,302
2,14,16,0,0,0,4,303
3,10,13,0,0,0,4,304
15,12,27,0,0,0,4,305
20,13,33,0,0,0,4,306
12,18,30,0,0,0,4,307
36,48,84,0,1,1,4,308
4,5,9,0,0,0,4,309
1,7,8,0,0,0,4,310
23,17,40,0,0,0,4,311
69,32,101,0,0,0,4,312
17,12,29,1,0,1,4,313
9,4,13,0,0,0,4,314
27,42,69,0,1,1,4,315
0,0,0,0,0,0,4,316
400,224,624,1,0,1,4,317
145,259,404,1,2,3,4,318
6,19,25,0,0,0,4,319
10,96,106,0,0,0,4,320
45,33,78,0,1,1,4,321
27,20,47,0,0,0,4,322
23,11,34,0,0,0,4,323
11,13,24,0,0,0,4,324
12,6,18,0,0,0,4,325
6,30,36,0,0,0,4,326
27,87,114,0,0,0,4,327
107,84,191,1,2,3,4,328
11,4,15,0,0,0,4,329
33,54,87,0,0,0,4,330
14,48,62,1,0,1,4,331
11,24,35,0,0,0,4,332
15,5,20,0,0,0,4,333
18,4,22,0,0,0,4,334
145,151,296,0,0,0,4,335
8,6,14,0,0,0,4,336
1,7,8,0,0,0,4,337
12,4,16,1,0,1,4,338
4,1,5,0,0,0,4,339
35,49,84,1,1,2,4,340
43,73,116,1,0,1,4,341
9,4,13,0,0,0,4,342
1,0,1,0,0,0,4,343
9,5,14,0,0,0,4,344
19,23,42,1,0,1,4,345
33,12,45,1,0,1,4,346
10,10,20,0,0,0,4,347
5,10,15,0,0,0,4,348
15,30,45,0,0,0,4,349
1,0,1,0,0,0,4,350
1,2,3,0,0,0,4,351
0,0,0,0,0,0,4,352
1,4,5,0,1,1,4,353
0,0,0,0,0,0,4,354
6,7,13,0,0,0,4,355
7,0,7,0,0,0,4,356
0,0,0,0,0,0,4,357
0,0,0,0,0,0,4,358
5,10,15,0,2,2,4,359
2,1,3,0,0,0,4,360
1,1,2,0,0,0,4,361
3,1,4,0,0,0,4,362
28,88,116,1,0,1,4,363
46,89,135,1,1,2,4,364
8,8,16,0,0,0,4,365
13,14,27,0,1,1,4,366
20,79,99,0,0,0,4,367
2,9,11,0,0,0,4,368
10,3,13,0,0,0,4,369
2,2,4,0,0,0,4,370
1,0,1,0,0,0,4,371
5,0,5,0,0,0,4,372
20,74,94,0,2,2,4,373
18,3,21,0,0,0,4,374
24,10,34,0,0,0,4,375
1,6,7,0,0,0,4,376
1,2,3,0,1,1,4,377
4,4,8,0,0,0,4,378
602,51,653,11,3,14,4,379
9,5,14,0,0,0,4,380
2,1,3,0,0,0,4,381
25,6,31,0,0,0,4,382
53,18,71,1,0,1,4,383
22,6,28,0,0,0,4,384
5,2,7,0,0,0,4,385
3,0,3,0,0,0,4,386
22,8,30,0,0,0,4,387
13,11,24,1,0,1,4,388
24,27,51,0,0,0,4,389
213,51,264,6,0,6,4,390
73,55,128,0,1,1,4,391
93,33,126,0,0,0,4,392
13,7,20,1,0,1,4,393
11,28,39,0,0,0,4,394
4,6,10,0,0,0,4,395
13,3,16,0,0,0,4,396
3,0,3,0,0,0,4,397
15,7,22,1,0,1,4,398
8,44,52,0,2,2,4,399
6,7,13,0,0,0,4,400
1,0,1,0,0,0,4,401
4,1,5,0,0,0,4,402
1,7,8,0,0,0,4,403
0,0,0,0,0,0,4,404
2,0,2,0,0,0,4,405
0,1,1,0,0,0,4,406
21,25,46,0,0,0,4,407
2,1,3,0,0,0,4,408
5,12,17,0,0,0,4,409
43,24,67,1,2,3,4,410
4,16,20,0,0,0,4,411
6,4,10,0,0,0,4,412
16,12,28,0,0,0,4,413
45,39,84,2,0,2,4,414
35,99,134,0,0,0,4,415
1,2,3,0,0,0,4,416
2,5,7,0,0,0,4,417
149,58,207,3,0,3,4,418
57,45,102,0,0,0,4,419
98,37,135,0,0,0,4,420
6,1,7,0,0,0,4,421
0,1,1,0,0,0,4,422
3,2,5,0,0,0,4,423
6,8,14,0,0,0,4,424
0,2,2,0,0,0,4,425
3,0,3,0,0,0,4,426
8,18,26,0,0,0,4,427
6,0,6,0,0,0,4,428
83,208,291,0,6,6,4,429
29,89,118,1,4,5,4,430
4,24,28,0,2,2,4,431
18,20,38,0,0,0,4,432
18,88,106,0,1,1,4,433
16,4,20,0,0,0,4,434
23,5,28,1,1,2,4,435
8,3,11,0,0,0,4,436
8,0,8,0,0,0,4,437
0,0,0,0,0,0,4,438
5,15,20,0,0,0,4,439
16,10,26,0,0,0,4,440
6,0,6,0,0,0,4,441
7,14,21,0,0,0,4,442
10,10,20,0,0,0,4,443
2,4,6,0,0,0,4,444
13,3,16,0,0,0,4,445
32,4,36,0,0,0,4,446
1446,610,2056,12,5,17,4,447
539,191,730,3,2,5,4,448
481,175,656,8,1,9,4,449
376,79,455,2,1,3,4,450
101,496,597,0,2,2,4,451
9,34,43,0,0,0,4,452
0,0,0,0,0,0,4,453
67,31,98,2,0,2,4,454
3,7,10,0,0,0,4,455
13,0,13,0,0,0,4,456
492,83,575,0,0,0,4,457
12,5,17,0,0,0,4,458
4,2,6,0,0,0,4,459
1,1,2,0,0,0,4,460
7,5,12,0,0,0,4,461
8,1,9,0,0,0,4,462
20,6,26,0,0,0,4,463
4,1,5,0,0,0,4,464
33,4,37,0,0,0,4,465
57,55,112,1,2,3,4,466
982,5060,6042,20,49,69,4,467
10,69,79,0,0,0,4,468
43,55,98,0,0,0,4,469
100,11,111,0,0,0,4,470
6,6,12,0,0,0,4,471
11,2,13,0,0,0,4,472
7,2,9,0,0,0,4,473
17,10,27,0,0,0,4,474
21,10,31,0,0,0,4,475
4,0,4,0,0,0,4,476
0,2,2,0,0,0,4,477
13,2,15,0,0,0,4,478
32,22,54,0,0,0,4,479
12,6,18,0,1,1,4,480
510,309,819,3,1,4,4,481
12,4,16,0,0,0,4,482
7,3,10,0,0,0,4,483
26,7,33,0,1,1,4,484
21,1,22,0,0,0,4,485
1,2,3,0,0,0,4,486
46,16,62,0,0,0,4,487
178,214,392,0,2,2,4,488
4,2,6,0,0,0,4,489
3,3,6,0,0,0,4,490
2,0,2,0,0,0,4,491
7,10,17,0,0,0,4,492
3,5,8,0,0,0,4,493
181,427,608,1,5,6,4,494
189,490,679,2,0,2,4,495
3,2,5,0,0,0,4,496
4,4,8,0,0,0,4,497
16,32,48,0,0,0,4,498
69,105,174,0,2,2,4,499
34,31,65,1,2,3,4,500
4,0,4,0,0,0,4,501
12,8,20,0,0,0,4,502
11,7,18,0,0,0,4,503
0,3,3,0,0,0,4,504
5,1,6,0,0,0,4,505
3,0,3,0,0,0,4,506
9,3,12,0,0,0,4,507
5,2,7,0,0,0,4,508
12,11,23,0,1,1,4,509
15,4,19,0,0,0,4,510
16,3,19,0,0,0,4,511
500,1031,1531,31,46,77,4,512
125,464,589,0,5,5,4,513
11,12,23,0,1,1,4,514
5,0,5,0,0,0,4,515
1373,162,1535,9,0,9,4,516
48,30,78,0,0,0,4,517
12,4,16,0,0,0,4,518
6,0,6,0,0,0,4,519
10,1,11,0,0,0,4,520
16,4,20,0,0,0,4,521
13,2,15,0,0,0,4,522
39,36,75,0,0,0,4,523
23,18,41,0,0,0,4,524
55,9,64,0,0,0,4,525
33,1,34,0,0,0,4,526
25,11,36,0,0,0,4,527
51863,48085,99948,228,176,404,4,528
416,806,1222,2,8,10,4,529
1567,3153,4720,2,7,9,4,530
311,720,1031,2,4,6,4,531
23287,52553,75840,54,119,173,4,532
5118,16116,21234,3,4,7,4,533
16112,43309,59421,47,138,185,4,534
3823,6944,10767,25,25,50,4,535
6008,13877,19885,17,40,57,4,536
3934,11213,15147,23,82,105,4,537
112,179,291,1,5,6,4,538
100,90,190,1,0,1,4,539
1008,988,1996,11,4,15,4,540
438,525,963,5,4,9,4,541
1437,885,2322,7,2,9,4,542
967,627,1594,2,0,2,4,543
896,513,1409,8,4,12,4,544
66,54,120,0,0,0,4,545
493,637,1130,8,8,16,4,546
235,288,523,1,3,4,4,547
2706,3069,5775,26,20,46,4,548
5,5,10,0,0,0,4,549
8,4,12,0,0,0,4,550
10,4,14,0,0,0,4,551
5,2,7,0,0,0,4,552
9,3,12,0,0,0,4,553
35,11,46,0,1,1,4,554
12,0,12,0,0,0,4,555
24,2,26,0,0,0,4,556
2,0,2,0,0,0,4,557
162,19,181,1,0,1,4,558
2,2,4,0,0,0,4,559
3,3,6,0,0,0,4,560
17,2,19,0,0,0,4,561
2,4,6,0,0,0,4,562
2,1,3,0,0,0,4,563
7,2,9,0,0,0,4,564
4,4,8,0,0,0,4,565
12,4,16,0,0,0,4,566
5,2,7,0,0,0,4,567
4,3,7,0,0,0,4,568
13,3,16,1,0,1,4,569
28,34,62,0,0,0,4,570
6,3,9,0,0,0,4,571
4,12,16,0,0,0,4,572
0,0,0,0,0,0,4,573
1,0,1,0,0,0,4,574
35,9,44,0,0,0,4,575
11,3,14,0,0,0,4,576
0,0,0,0,0,0,4,577
5,10,15,0,0,0,4,578
58,119,177,0,1,1,4,579
4,23,27,0,1,1,4,580
5,21,26,0,0,0,4,581
58,22,80,0,0,0,4,582
7,4,11,1,0,1,4,583
6,4,10,0,0,0,4,584
27,11,38,0,1,1,4,585
3,13,16,0,0,0,4,586
9,3,12,0,0,0,4,587
30,25,55,0,0,0,4,588
20,18,38,0,0,0,4,589
20,54,74,1,0,1,4,590
14,23,37,0,0,0,4,591
6965,5400,12365,53,30,83,4,592
42,40,82,0,0,0,4,593
32,20,52,0,0,0,4,594
38,111,149,2,1,3,4,595
2,5,7,0,0,0,4,596
6,4,10,0,0,0,4,597
4,1,5,1,0,1,4,598
0,2,2,0,0,0,4,599
128,56,184,1,0,1,4,600
16,4,20,0,0,0,4,601
41,31,72,0,0,0,4,602
26,8,34,0,0,0,4,603
113,17,130,1,0,1,4,604
82,22,104,0,1,1,4,605
9,2,11,0,0,0,4,606
56,21,77,4,2,6,4,607
23,14,37,0,0,0,4,608
16,1,17,0,0,0,4,609
95,6,101,1,0,1,4,610
31,7,38,0,0,0,4,611
1,2,3,0,0,0,4,612
401,155,556,13,3,16,4,613
3,2,5,0,0,0,4,614
4,0,4,0,0,0,4,615
2,0,2,0,0,0,4,616
4,9,13,0,0,0,4,617
4,0,4,0,0,0,4,618
2,0,2,0,0,0,4,619
5,1,6,0,0,0,4,620
3,3,6,0,0,0,4,621
11,5,16,0,0,0,4,622
5,5,10,0,0,0,4,623
1,0,1,0,0,0,4,624
10,38,48,0,3,3,4,625
1,0,1,0,0,0,4,626
2,0,2,0,0,0,4,627
3,1,4,0,0,0,4,628
1,4,5,0,0,0,4,629
7,3,10,0,0,0,4,630
5,8,13,0,0,0,4,631
28,19,47,0,0,0,4,632
0,2,2,0,0,0,4,633
2,0,2,0,0,0,4,634
331,43,374,2,1,3,4,635
1,2,3,0,0,0,4,636
3,4,7,0,0,0,4,637
7,6,13,0,0,0,4,638
6,0,6,0,0,0,4,639
9,5,14,0,0,0,4,640
5,7,12,0,0,0,4,641
4,0,4,0,0,0,4,642
2,1,3,0,0,0,4,643
2,0,2,0,0,0,4,644
5,1,6,0,0,0,4,645
1,2,3,0,0,0,4,646
3,0,3,0,0,0,4,647
0,0,0,0,0,0,4,648
5,3,8,0,0,0,4,649
30,26,56,0,1,1,4,650
878,383,1261,5,4,9,4,651
6996,825,7821,33,5,38,4,652
525,566,1091,9,6,15,4,653
524,532,1056,2,2,4,4,654
20,4,24,0,0,0,4,655
0,0,0,0,0,0,4,656
5,4,9,0,0,0,4,657
5,3,8,0,0,0,4,658
61,129,190,0,6,6,4,659
1217,4695,5912,11,52,63,4,660
8,0,8,0,0,0,4,661
7,4,11,0,0,0,4,662
8,7,15,0,0,0,4,663
1,2,3,0,0,0,4,664
6,3,9,0,0,0,4,665
43,31,74,0,0,0,4,666
35,49,84,0,0,0,4,667
5,3,8,0,0,0,4,668
11,14,25,0,1,1,4,669
11,2,13,0,0,0,4,670
17,19,36,0,0,0,4,671
2,2,4,0,0,0,4,672
2,9,11,0,0,0,4,673
3,9,12,0,0,0,4,674
11,6,17,0,0,0,4,675
2,2,4,0,0,0,4,676
3,15,18,0,0,0,4,677
3,5,8,0,0,0,4,678
2,3,5,0,0,0,4,679
4,4,8,0,0,0,4,680
40,93,133,0,2,2,4,681
3,8,11,0,0,0,4,682
1,2,3,0,0,0,4,683
60,55,115,0,0,0,4,684
34,50,84,0,5,5,4,685
317,159,476,5,4,9,4,686
21,60,81,0,0,0,4,687
40,119,159,0,2,2,4,688
5,8,13,0,0,0,4,689
7,13,20,0,0,0,4,690
19,24,43,0,0,0,4,691
13,48,61,0,0,0,4,692
38,136,174,0,0,0,4,693
15,14,29,1,0,1,4,694
34,12,46,0,0,0,4,695
20,24,44,0,0,0,4,696
1,3,4,0,0,0,4,697
76,297,373,0,4,4,4,698
38,42,80,1,0,1,4,699
11,11,22,0,0,0,4,700
8,2,10,0,0,0,4,701
6,5,11,0,0,0,4,702
3,3,6,0,0,0,4,703
9,7,16,0,0,0,4,704
1,8,9,0,1,1,4,705
7,10,17,0,0,0,4,706
11,14,25,0,0,0,4,707
10,2,12,0,0,0,4,708
1,15,16,0,0,0,4,709
4,15,19,0,0,0,4,710
8,1,9,0,0,0,4,711
4,0,4,0,0,0,4,712
60,270,330,0,0,0,4,713
28,30,58,0,0,0,4,714
57,84,141,0,1,1,4,715
60,112,172,1,1,2,4,716
37,68,105,0,0,0,4,717
14,5,19,0,0,0,4,718
18,22,40,0,0,0,4,719
49,31,80,1,0,1,4,720
2,7,9,0,0,0,4,721
29,219,248,0,1,1,4,722
16,85,101,0,0,0,4,723
11,15,26,0,0,0,4,724
4,8,12,0,0,0,4,725
5,3,8,0,0,0,4,726
4,3,7,0,0,0,4,727
0,3,3,0,0,0,4,728
2,5,7,0,0,0,4,729
3,5,8,0,0,0,4,730
1,4,5,0,0,0,4,731
2,3,5,0,0,0,4,732
2,5,7,0,0,0,4,733
1,4,5,0,0,0,4,734
5,7,12,0,0,0,4,735
4,2,6,0,0,0,4,736
0,0,0,0,0,0,4,737
2,2,4,0,0,0,4,738
7,1,8,0,0,0,4,739
2,0,2,0,0,0,4,740
9,34,43,0,0,0,4,741
0,3,3,0,0,0,4,742
11,1,12,0,0,0,4,743
25,10,35,1,0,1,4,744
34,77,111,0,3,3,4,745
3,11,14,0,0,0,4,746
4,1,5,0,0,0,4,747
6,7,13,0,0,0,4,748
4,2,6,0,0,0,4,749
2,2,4,0,0,0,4,750
7,1,8,0,0,0,4,751
6,13,19,0,0,0,4,752
49,82,131,0,1,1,4,753
5,7,12,0,0,0,4,754
2,3,5,0,0,0,4,755
3,3,6,0,0,0,4,756
8,5,13,0,0,0,4,757
1,0,1,0,0,0,4,758
1,0,1,0,0,0,4,759
0,0,0,0,0,0,4,760
1,0,1,0,0,0,4,761
0,0,0,0,0,0,4,762
1,1,2,0,0,0,4,763
1,0,1,0,0,0,4,764
1,1,2,0,0,0,4,765
0,0,0,0,0,0,4,766
4,10,14,0,0,0,4,767
7,18,25,0,0,0,4,768
0,4,4,0,0,0,4,769
11,0,11,0,0,0,4,770
1,1,2,0,0,0,4,771
0,1,1,0,0,0,4,772
23,5,28,0,0,0,4,773
1559,396,1955,2,1,3,4,774
49,35,84,0,1,1,4,775
64,11,75,0,0,0,4,776
735,939,1674,10,34,44,4,777
100,961,1061,2,25,27,4,778
7,6,13,0,0,0,4,779
9,6,15,0,0,0,4,780
15,36,51,0,0,0,4,781
5,1,6,0,0,0,4,782
6,11,17,0,0,0,4,783
569,1005,1574,1,7,8,4,784
183,57,240,0,0,0,4,785
386,610,996,3,1,4,4,786
21,47,68,0,1,1,4,787
249,888,1137,1,3,4,4,788
115,206,321,0,0,0,4,789
62,74,136,0,2,2,4,790
140,751,891,1,8,9,4,791
8,1,9,0,0,0,4,792
6,3,9,0,0,0,4,793
7,3,10,0,0,0,4,794
202,43,245,4,0,4,4,795
9,7,16,0,0,0,4,796
5,1,6,0,0,0,4,797
6,0,6,0,0,0,4,798
35,6,41,0,0,0,4,799
3,1,4,0,0,0,4,800
86,15,101,0,0,0,4,801
147,23,170,0,1,1,4,802
134,127,261,0,1,1,4,803
20,8,28,0,0,0,4,804
13,21,34,0,0,0,4,805
17,6,23,0,0,0,4,806
66,91,157,0,1,1,4,807
7,8,15,0,0,0,4,808
7,0,7,0,0,0,4,809
7,4,11,0,0,0,4,810
2,2,4,0,0,0,4,811
2,1,3,0,0,0,4,812
34,16,50,0,0,0,4,813
5,0,5,0,0,0,4,814
52,19,71,1,0,1,4,815
85,4,89,0,0,0,4,816
90,109,199,0,0,0,4,817
364,173,537,9,0,9,4,818
158,101,259,1,1,2,4,819
1945,1260,3205,22,12,34,4,820
35,23,58,0,0,0,4,821
1759,658,2417,12,6,18,4,822
30,52,82,0,0,0,4,823
625,246,871,5,0,5,4,824
1081,388,1469,8,1,9,4,825
769,600,1369,2,5,7,4,826
13,4,17,0,0,0,4,827
31,14,45,0,0,0,4,828
7,3,10,0,0,0,4,829
15,21,36,0,0,0,4,830
4,1,5,0,0,0,4,831
37,10,47,0,0,0,4,832
4,4,8,0,0,0,4,833
31,7,38,0,0,0,4,834
4,2,6,0,0,0,4,835
93,119,212,2,0,2,4,836
8,3,11,0,0,0,4,837
22,17,39,1,0,1,4,838
8,3,11,0,0,0,4,839
4,4,8,0,0,0,4,840
36,22,58,0,1,1,4,841
50,57,107,0,0,0,4,842
20,43,63,0,0,0,4,843
2,9,11,0,0,0,4,844
8,5,13,0,0,0,4,845
23,5,28,0,0,0,4,846
3,1,4,0,0,0,4,847
6,1,7,0,0,0,4,848
15,9,24,1,0,1,4,849
284,272,556,7,5,12,4,850
461,405,866,11,11,22,4,851
5,6,11,1,0,1,4,852
39,29,68,2,1,3,4,853
7,21,28,0,1,1,4,854
7,15,22,0,0,0,4,855
13,21,34,0,0,0,4,856
35,9,44,2,0,2,4,857
14,5,19,0,0,0,4,858
9,20,29,0,0,0,4,859
10,5,15,0,0,0,4,860
16,5,21,0,0,0,4,861
48,40,88,0,0,0,4,862
7,45,52,0,0,0,4,863
15,7,22,1,0,1,4,864
24,112,136,1,0,1,4,865
29,11,40,0,0,0,4,866
4,8,12,0,0,0,4,867
8,0,8,0,0,0,4,868
11,3,14,0,0,0,4,869
63,5,68,0,0,0,4,870
1324,210,1534,27,0,27,4,871
127,68,195,1,0,1,4,872
50,19,69,0,0,0,4,873
36,22,58,2,1,3,4,874
6,4,10,0,0,0,4,875
164,83,247,0,0,0,4,876
157,68,225,0,0,0,4,877
133,78,211,0,1,1,4,878
13,6,19,0,0,0,4,879
8,9,17,0,0,0,4,880
76,7,83,0,0,0,4,881
10,34,44,0,0,0,4,882
7,8,15,0,0,0,4,883
11,6,17,1,0,1,4,884
5,11,16,1,1,2,4,885
10,5,15,0,0,0,4,886
11,5,16,0,0,0,4,887
14,4,18,0,0,0,4,888
17,20,37,0,0,0,4,889
7,3,10,0,0,0,4,890
22,16,38,0,1,1,4,891
1,0,1,0,0,0,4,892
14,12,26,0,0,0,4,893
8,3,11,0,0,0,4,894
100,37,137,1,1,2,4,895
30,29,59,0,1,1,4,896
5,0,5,0,0,0,4,897
2,0,2,0,0,0,4,898
0,1,1,0,0,0,4,899
1,3,4,0,0,0,4,900
3,3,6,0,0,0,4,901
2,2,4,0,0,0,4,902
12,10,22,0,0,0,4,903
10,13,23,0,0,0,4,904
10,16,26,0,0,0,4,905
24,8,32,0,0,0,4,906
2,4,6,0,0,0,4,907
7,4,11,0,0,0,4,908
4,0,4,0,0,0,4,909
3,3,6,0,0,0,4,910
4,1,5,0,0,0,4,911
3,5,8,0,0,0,4,912
37,8,45,0,0,0,4,913
12,15,27,0,0,0,4,914
4,18,22,0,0,0,4,915
3,4,7,0,0,0,4,916
1,4,5,1,0,1,4,917
2,5,7,0,0,0,4,918
29,125,154,0,2,2,4,919
21,14,35,0,0,0,4,920
18,4,22,0,0,0,4,921
0,1,1,0,0,0,4,922
5,9,14,0,1,1,4,923
2,1,3,0,0,0,4,924
6,17,23,0,2,2,4,925
1,0,1,0,0,0,4,926
0,4,4,0,1,1,4,927
1,3,4,0,0,0,4,928
5,13,18,0,0,0,4,929
4,1,5,0,0,0,4,930
0,1,1,0,0,0,4,931
2,4,6,0,1,1,4,932
0,3,3,0,1,1,4,933
1,2,3,0,0,0,4,934
0,3,3,0,0,0,4,935
0,0,0,0,0,0,4,936
1,2,3,0,0,0,4,937
4,11,15,0,0,0,4,938
0,1,1,0,0,0,4,939
2,4,6,0,0,0,4,940
10,6,16,0,0,0,4,941
2,2,4,0,0,0,4,942
16,27,43,0,0,0,4,943
2,1,3,0,0,0,4,944
24,48,72,0,0,0,4,945
3,4,7,0,0,0,4,946
1,3,4,0,0,0,4,947
41,46,87,0,0,0,4,948
1,1,2,0,0,0,4,949
3,0,3,0,0,0,4,950
2352,918,3270,4,2,6,4,951
346,129,475,0,1,1,4,952
2,0,2,0,0,0,4,953
8,2,10,0,0,0,4,954
12,5,17,0,0,0,4,955
49,21,70,0,0,0,4,956
38,99,137,0,0,0,4,957
1,1,2,0,0,0,4,958
287,553,840,1,3,4,4,959
5,1,6,0,0,0,4,960
2,4,6,0,0,0,4,961
4,1,5,0,0,0,4,962
14,5,19,0,0,0,4,963
14,3,17,0,0,0,4,964
2,0,2,0,0,0,4,965
5,4,9,0,0,0,4,966
7,4,11,0,0,0,4,967
5,4,9,0,0,0,4,968
2,2,4,0,0,0,4,969
3,0,3,0,0,0,4,970
6,1,7,0,0,0,4,971
2,1,3,0,0,0,4,972
26,14,40,0,1,1,4,973
2,7,9,0,0,0,4,974
17,5,22,0,0,0,4,975
10,3,13,0,0,0,4,976
11,6,17,0,0,0,4,977
20,23,43,2,0,2,4,978
61,16,77,2,0,2,4,979
25,5,30,0,0,0,4,980
3,6,9,0,0,0,4,981
6,1,7,0,0,0,4,982
7,11,18,0,0,0,4,983
300,42,342,1,0,1,4,984
14,2,16,0,0,0,4,985
37,12,49,1,0,1,4,986
22,9,31,0,2,2,4,987
27,12,39,0,0,0,4,988
8,4,12,0,0,0,4,989
2,1,3,0,0,0,4,990
17,7,24,0,0,0,4,991
9,0,9,0,0,0,4,992
5,1,6,0,0,0,4,993
7,3,10,0,0,0,4,994
6,2,8,0,0,0,4,995
1331,1566,2897,4,11,15,4,996
0,0,0,0,0,0,4,997
46,76,122,0,0,0,4,998
23,43,66,0,2,2,4,999
12,14,26,0,0,0,4,1000
1,5,6,0,0,0,4,1001
7,5,12,0,0,0,4,1002
17,3,20,0,0,0,4,1003
4,5,9,0,0,0,4,1004
0,0,0,0,0,0,4,1005
841,500,1341,13,6,19,4,1006
73,197,270,1,2,3,4,1007
5,1,6,0,0,0,4,1008
6,5,11,0,0,0,4,1009
5,2,7,0,0,0,4,1010
6,1,7,0,0,0,4,1011
18,6,24,0,0,0,4,1012
5,10,15,0,0,0,4,1013
1,8,9,0,0,0,4,1014
4,4,8,1,2,3,4,1015
36,56,92,0,5,5,4,1016
0,0,0,0,0,0,4,1017
5,0,5,0,0,0,4,1018
1,3,4,0,0,0,4,1019
2,0,2,0,0,0,4,1020
1,0,1,0,0,0,4,1021
0,0,0,0,0,0,4,1022
1,1,2,0,0,0,4,1023
1,0,1,0,0,0,4,1024
0,2,2,0,0,0,4,1025
0,1,1,0,0,0,4,1026
173,222,395,4,3,7,4,1027
4,9,13,0,0,0,4,1028
0,1,1,0,0,0,4,1029
3,0,3,0,0,0,4,1030
5,1,6,0,0,0,4,1031
6,0,6,0,0,0,4,1032
5,6,11,0,0,0,4,1033
1,1,2,0,0,0,4,1034
2,2,4,0,0,0,4,1035
0,2,2,0,0,0,4,1036
2,0,2,0,0,0,4,1037
13,1,14,0,0,0,4,1038
3,8,11,0,0,0,4,1039
33,87,120,0,0,0,4,1040
162,595,757,2,12,14,4,1041
6,1,7,0,0,0,4,1042
8,10,18,0,0,0,4,1043
3,5,8,0,0,0,4,1044
14,6,20,0,0,0,4,1045
7,3,10,0,0,0,4,1046
133,154,287,1,4,5,4,1047
59,281,340,0,0,0,4,1048
55,27,82,0,0,0,4,1049
2,1,3,0,0,0,4,1050
23,17,40,0,0,0,4,1051
170,298,468,0,4,4,4,1052
11,11,22,0,0,0,4,1053
10,14,24,0,0,0,4,1054
15,2,17,0,0,0,4,1055
1,0,1,0,0,0,4,1056
13,7,20,0,0,0,4,1057
230,268,498,1,1,2,4,1058
373,244,617,5,4,9,4,1059
6,2,8,0,0,0,4,1060
66,186,252,1,0,1,4,1061
5,13,18,0,0,0,4,1062
3,16,19,0,0,0,4,1063
1206,1771,2977,16,22,38,4,1064
142,816,958,3,30,33,4,1065
200,651,851,1,4,5,4,1066
80,258,338,0,3,3,4,1067
32,65,97,0,0,0,4,1068
11,10,21,0,0,0,4,1069
0,0,0,0,0,0,4,1070
21,16,37,0,0,0,4,1071
186,252,438,1,2,3,4,1072
2,4,6,0,0,0,4,1073
0,2,2,0,0,0,4,1074
1,2,3,0,0,0,4,1075
7,0,7,0,0,0,4,1076
3,3,6,0,0,0,4,1077
2,23,25,0,0,0,4,1078
8,7,15,0,0,0,4,1079
15,15,30,0,0,0,4,1080
2,4,6,0,0,0,4,1081
23,9,32,0,0,0,4,1082
8,11,19,0,0,0,4,1083
1745,1249,2994,21,13,34,4,1084
18,4,22,0,0,0,4,1085
7,4,11,0,0,0,4,1086
41,27,68,0,0,0,4,1087
7,4,11,0,0,0,4,1088
22,22,44,0,0,0,4,1089
33,76,109,0,0,0,4,1090
0,1,1,0,0,0,4,1091
58,31,89,1,1,2,4,1092
253,105,358,5,1,6,4,1093
81,12,93,0,0,0,4,1094
23,10,33,0,0,0,4,1095
29,14,43,0,1,1,4,1096
38,18,56,0,0,0,4,1097
67,42,109,0,1,1,4,1098
1704,1217,2921,4,3,7,4,1099
13,17,30,0,0,0,4,1100
49,20,69,0,0,0,4,1101
26,3,29,0,0,0,4,1102
63,32,95,1,0,1,4,1103
5,14,19,0,0,0,4,1104
14,6,20,0,0,0,4,1105
13,3,16,0,0,0,4,1106
3,2,5,0,0,0,4,1107
2,1,3,0,0,0,4,1108
4,6,10,0,0,0,4,1109
5,2,7,0,0,0,4,1110
3,0,3,0,0,0,4,1111
22,1,23,0,0,0,4,1112
19,1,20,0,0,0,4,1113
8,5,13,0,0,0,4,1114
8,6,14,0,0,0,4,1115
5,19,24,0,0,0,4,1116
15,8,23,0,0,0,4,1117
15,13,28,0,1,1,4,1118
381,1201,1582,3,6,9,4,1119
170,1002,1172,6,20,26,4,1120
74,206,280,1,0,1,4,1121
1365,253,1618,2,0,2,4,1122
18,4,22,0,0,0,4,1123
482,1286,1768,6,10,16,4,1124
43,80,123,0,0,0,4,1125
5,5,10,1,0,1,4,1126
1,8,9,0,0,0,4,1127
7,28,35,0,3,3,4,1128
0,2,2,0,0,0,4,1129
2,1,3,0,0,0,4,1130
1,2,3,0,0,0,4,1131
2,0,2,0,0,0,4,1132
644,929,1573,2,0,2,4,1133
2,0,2,0,0,0,4,1134
4,5,9,0,0,0,4,1135
29,51,80,0,2,2,4,1136
170,270,440,1,1,2,4,1137
10,3,13,0,0,0,4,1138
15,0,15,0,0,0,4,1139
8,10,18,0,0,0,4,1140
0,2,2,0,0,0,4,1141
8,11,19,0,0,0,4,1142
11,31,42,1,0,1,4,1143
0,0,0,0,0,0,4,1144
4,6,10,0,0,0,4,1145
4134,3311,7445,43,61,104,4,1146
152,8,160,0,0,0,4,1147
13,6,19,0,0,0,4,1148
43,28,71,0,0,0,4,1149
40,18,58,0,1,1,4,1150
0,0,0,0,0,0,4,1151
235,599,834,4,4,8,4,1152
56,180,236,0,1,1,4,1153
28,10,38,0,0,0,4,1154
12,13,25,0,0,0,4,1155
50,69,119,0,2,2,4,1156
15,10,25,0,0,0,4,1157
11,2,13,0,0,0,4,1158
27,10,37,0,1,1,4,1159
44,37,81,0,0,0,4,1160
43,85,128,1,0,1,4,1161
197,308,505,2,1,3,4,1162
41,91,132,0,0,0,4,1163
39,42,81,0,0,0,4,1164
8,1,9,0,0,0,4,1165
2195,3548,5743,7,18,25,4,1166
292,229,521,0,1,1,4,1167
9,22,31,0,0,0,4,1168
185,154,339,1,1,2,4,1169
12167,5712,17879,39,32,71,4,1170
30,24,54,0,0,0,4,1171
195,55,250,0,0,0,4,1172
28,5,33,0,0,0,4,1173
7,5,12,0,0,0,4,1174
1299,355,1654,12,3,15,4,1175
215,165,380,1,1,2,4,1176
275,428,703,0,1,1,4,1177
67,7,74,0,0,0,4,1178
636208,181088,817296,602,235,837,4,1179
262,104,366,0,1,1,4,1180
121,53,174,3,1,4,4,1181
76,37,113,3,0,3,4,1182
677,224,901,13,2,15,4,1183
125,93,218,3,0,3,4,1184
0,0,0,0,0,0,4,1185
77,130,207,0,0,0,4,1186
261,391,652,1,3,4,4,1187
252,365,617,1,2,3,4,1188
219,74,293,1,1,2,4,1189
11,6,17,1,0,1,4,1190
54,16,70,0,0,0,4,1191
1082,1946,3028,10,18,28,4,1192
0,0,0,0,0,0,4,1193
146,867,1013,1,4,5,4,1194
1029,1344,2373,7,10,17,4,1195
0,0,0,0,0,0,4,1196
982,1115,2097,2,5,7,4,1197
2701,5334,8035,24,44,68,4,1198
76,124,200,0,0,0,4,1199
119,191,310,2,7,9,4,1200
2395,1748,4143,41,25,66,4,1201
3,4,7,0,0,0,4,1202
8,4,12,0,0,0,4,1203
1,2,3,0,0,0,4,1204
0,0,0,0,0,0,4,1205
1525,1458,2983,9,9,18,4,1206
7,24,31,0,0,0,4,1207
91,31,122,0,0,0,4,1208
132,43,175,0,0,0,4,1209
0,0,0,0,0,0,4,1210
0,0,0,0,0,0,4,1211
241,53,294,1,0,1,4,1212
115,16,131,1,0,1,4,1213
1559,1954,3513,11,14,25,4,1214
13,14,27,0,0,0,4,1215
163,67,230,0,1,1,4,1216
14,5,19,0,0,0,4,1217
8,4,12,0,0,0,4,1218
5,1,6,0,0,0,4,1219
2,0,2,0,0,0,4,1220
0,0,0,0,0,0,4,1221
2,4,6,0,0,0,4,1222
0,0,0,0,0,0,4,1223
0,0,0,0,0,0,4,1224
0,0,0,0,0,0,4,1225
1,4,5,0,0,0,4,1226
2,0,2,0,0,0,4,1227
8,8,16,0,0,0,4,1228
6,1,7,0,0,0,4,1229
1,2,3,0,0,0,4,1230
0,0,0,0,0,0,4,1231
0,1,1,0,0,0,4,1232
17,14,31,0,0,0,4,1233
1,1,2,0,0,0,4,1234
0,1,1,0,0,0,4,1235
1,2,3,0,0,0,4,1236
1,0,1,0,0,0,4,1237
19,19,38,0,0,0,4,1238
4,1,5,0,0,0,4,1239
8,6,14,0,0,0,4,1240
8,5,13,0,0,0,4,1241
1,0,1,1,0,1,4,1242
3,1,4,0,0,0,4,1243
2,1,3,0,0,0,4,1244
4,6,10,0,0,0,4,1245
0,0,0,0,0,0,4,1246
1,1,2,0,0,0,4,1247
36,33,69,0,0,0,4,1248
5,1,6,0,0,0,4,1249
2,2,4,0,0,0,4,1250
0,0,0,-1,0,-1,4,1251
2,1,3,0,0,0,4,1252
5,0,5,0,0,0,4,1253
0,0,0,0,0,0,4,1254
39,46,85,0,0,0,4,1255
1,0,1,0,0,0,4,1256
2,1,3,0,0,0,4,1257
0,0,0,0,0,0,4,1258
1,0,1,0,0,0,4,1259
7,7,14,0,0,0,4,1260
33,12,45,0,0,0,4,1261
1,0,1,0,0,0,4,1262
13,4,17,1,0,1,4,1263
0,0,0,0,0,0,4,1264
1,0,1,0,0,0,4,1265
2,0,2,0,0,0,4,1266
6,4,10,0,0,0,4,1267
6,10,16,0,0,0,4,1268
5,0,5,0,0,0,4,1269
0,0,0,0,0,0,4,1270
6,0,6,0,0,0,4,1271
2,0,2,0,0,0,4,1272
13,13,26,0,0,0,4,1273
1,0,1,0,0,0,4,1274
1,1,2,0,0,0,4,1275
1,2,3,0,0,0,4,1276
4,1,5,0,0,0,4,1277
0,0,0,0,0,0,4,1278
1,1,2,0,0,0,4,1279
1,0,1,0,0,0,4,1280
0,0,0,0,0,0,4,1281
0,5,5,0,0,0,4,1282
8,3,11,0,0,0,4,1283
4,1,5,0,0,0,4,1284
0,1,1,0,0,0,4,1285
0,1,1,0,0,0,4,1286
0,0,0,0,0,0,4,1287
0,0,0,0,0,0,4,1288
3,0,3,0,0,0,4,1289
15,18,33,0,0,0,4,1290
0,2,2,0,0,0,4,1291
3,1,4,0,0,0,4,1292
4,2,6,0,0,0,4,1293
1,0,1,0,0,0,4,1294
2,4,6,0,0,0,4,1295
3,2,5,0,0,0,4,1296
0,0,0,0,0,0,4,1297
3,1,4,0,0,0,4,1298
13,4,17,0,0,0,4,1299
1,0,1,1,0,1,4,1300
0,0,0,0,0,0,4,1301
5,9,14,0,0,0,4,1302
3,3,6,0,0,0,4,1303
3,2,5,0,0,0,4,1304
5,1,6,0,0,0,4,1305
0,1,1,0,0,0,4,1306
3,5,8,0,0,0,4,1307
2,2,4,0,0,0,4,1308
5,4,9,0,0,0,4,1309
3,4,7,0,0,0,4,1310
0,2,2,0,0,0,4,1311
0,10,10,0,0,0,4,1312
2,0,2,0,0,0,4,1313
1,0,1,0,0,0,4,1314
0,1,1,0,0,0,4,1315
1,1,2,0,0,0,4,1316
0,0,0,0,0,0,4,1317
4,4,8,0,0,0,4,1318
6,2,8,0,0,0,4,1319
0,0,0,0,0,0,4,1320
2,0,2,0,0,0,4,1321
0,1,1,0,0,0,4,1322
0,0,0,0,0,0,4,1323
5,0,5,0,0,0,4,1324
0,2,2,0,0,0,4,1325
1,1,2,0,0,0,4,1326
7,0,7,0,0,0,4,1327
8,4,12,0,0,0,4,1328
1,0,1,0,0,0,4,1329
1,0,1,0,0,0,4,1330
4,2,6,0,0,0,4,1331
2,0,2,0,0,0,4,1332
1,0,1,0,0,0,4,1333
2,0,2,0,0,0,4,1334
2,1,3,0,0,0,4,1335
2,1,3,0,0,0,4,1336
4,6,10,0,0,0,4,1337
2,3,5,0,0,0,4,1338
2,1,3,1,0,1,4,1339
3,5,8,0,0,0,4,1340
8,0,8,0,0,0,4,1341
1,0,1,0,0,0,4,1342
0,1,1,0,0,0,4,1343
2,2,4,0,0,0,4,1344
2,0,2,0,0,0,4,1345
0,0,0,0,0,0,4,1346
0,0,0,0,0,0,4,1347
0,3,3,0,0,0,4,1348
1,4,5,0,0,0,4,1349
3,3,6,0,0,0,4,1350
4,6,10,0,0,0,4,1351
0,0,0,0,0,0,4,1352
0,0,0,0,0,0,4,1353
5,2,7,0,0,0,4,1354
0,0,0,0,0,0,4,1355
1,1,2,0,0,0,4,1356
0,1,1,0,0,0,4,1357
2,3,5,0,0,0,4,1358
4,0,4,0,0,0,4,1359
5,3,8,0,0,0,4,1360
22,23,45,0,0,0,4,1361
1,2,3,0,0,0,4,1362
4,4,8,0,0,0,4,1363
2,1,3,1,0,1,4,1364
0,0,0,0,0,0,4,1365
2,1,3,0,0,0,4,1366
3,3,6,0,0,0,4,1367
0,1,1,0,0,0,4,1368
2,1,3,0,0,0,4,1369
0,0,0,0,0,0,4,1370
5,0,5,0,0,0,4,1371
1,0,1,0,0,0,4,1372
2,0,2,0,0,0,4,1373
6,6,12,0,0,0,4,1374
1,1,2,0,0,0,4,1375
1,0,1,0,0,0,4,1376
1,0,1,0,0,0,4,1377
0,0,0,0,0,0,4,1378
0,0,0,0,0,0,4,1379
0,0,0,0,0,0,4,1380
0,1,1,0,0,0,4,1381
4,0,4,0,0,0,4,1382
36,26,62,0,0,0,4,1383
2,2,4,0,0,0,4,1384
4,0,4,0,0,0,4,1385
3,2,5,0,0,0,4,1386
4,0,4,0,0,0,4,1387
2,4,6,0,0,0,4,1388
3,4,7,0,0,0,4,1389
2,0,2,0,0,0,4,1390
5,3,8,0,0,0,4,1391
2,0,2,0,0,0,4,1392
3,1,4,0,0,0,4,1393
1,1,2,0,0,0,4,1394
23,91,114,0,0,0,4,1395
2,0,2,0,0,0,4,1396
2,2,4,0,0,0,4,1397
1,0,1,0,0,0,4,1398
5,5,10,0,0,0,4,1399
2,0,2,0,0,0,4,1400
4,1,5,0,0,0,4,1401
3,0,3,0,0,0,4,1402
13,8,21,0,0,0,4,1403
1,3,4,0,0,0,4,1404
2,7,9,0,0,0,4,1405
4,0,4,0,0,0,4,1406
3,3,6,0,0,0,4,1407
6,0,6,0,0,0,4,1408
1,2,3,0,0,0,4,1409
1,0,1,0,0,0,4,1410
6,1,7,0,0,0,4,1411
6,3,9,0,0,0,4,1412
2,4,6,0,0,0,4,1413
2,6,8,0,0,0,4,1414
3,0,3,0,0,0,4,1415
4,5,9,0,0,0,4,1416
1,0,1,0,0,0,4,1417
5,21,26,0,0,0,4,1418
9,2,11,0,0,0,4,1419
6,5,11,0,0,0,4,1420
3,5,8,0,0,0,4,1421
1,0,1,0,0,0,4,1422
1,2,3,0,0,0,4,1423
22,11,33,0,0,0,4,1424
5,14,19,0,0,0,4,1425
142,166,308,2,0,2,4,1426
1,1,2,0,0,0,4,1427
1,1,2,0,0,0,4,1428
0,0,0,0,0,0,4,1429
0,0,0,0,0,0,4,1430
1,0,1,0,0,0,4,1431
0,1,1,0,0,0,4,1432
1,5,6,0,0,0,4,1433
2,0,2,0,0,0,4,1434
0,1,1,0,0,0,4,1435
5,2,7,0,0,0,4,1436
1,5,6,1,0,1,4,1437
3,2,5,0,0,0,4,1438
3,2,5,0,0,0,4,1439
3,0,3,0,0,0,4,1440
7,0,7,0,0,0,4,1441
2,2,4,0,0,0,4,1442
2,4,6,0,1,1,4,1443
4,0,4,0,0,0,4,1444
2,3,5,0,0,0,4,1445
0,1,1,0,0,0,4,1446
1,2,3,0,0,0,4,1447
0,0,0,0,0,0,4,1448
5,1,6,0,0,0,4,1449
0,1,1,0,0,0,4,1450
3,2,5,0,0,0,4,1451
0,0,0,0,0,0,4,1452
1,1,2,0,0,0,4,1453
3,1,4,0,0,0,4,1454
24,13,37,0,0,0,4,1455
3,3,6,0,0,0,4,1456
2,0,2,0,0,0,4,1457
2,0,2,0,0,0,4,1458
0,2,2,0,0,0,4,1459
1,2,3,0,0,0,4,1460
0,0,0,0,0,0,4,1461
4,1,5,0,0,0,4,1462
23,19,42,0,1,1,4,1463
0,1,1,0,0,0,4,1464
1,1,2,0,0,0,4,1465
4,1,5,0,0,0,4,1466
0,0,0,0,0,0,4,1467
4,0,4,0,0,0,4,1468
5,2,7,0,0,0,4,1469
5,1,6,0,0,0,4,1470
1,0,1,0,0,0,4,1471
3,2,5,1,0,1,4,1472
2,0,2,0,0,0,4,1473
2,4,6,0,0,0,4,1474
2,5,7,0,0,0,4,1475
46,5,51,0,0,0,4,1476
3,2,5,0,0,0,4,1477
2,4,6,0,0,0,4,1478
1,3,4,0,0,0,4,1479
1,0,1,0,0,0,4,1480
1,0,1,0,0,0,4,1481
3,2,5,0,0,0,4,1482
15,20,35,1,1,2,4,1483
10,1,11,0,0,0,4,1484
5,1,6,0,0,0,4,1485
1,3,4,0,0,0,4,1486
202,119,321,3,2,5,4,1487
1,0,1,0,0,0,4,1488
0,0,0,0,0,0,4,1489
3,0,3,0,0,0,4,1490
1,0,1,0,0,0,4,1491
4,1,5,0,0,0,4,1492
4,1,5,0,0,0,4,1493
2,4,6,0,0,0,4,1494
0,0,0,0,0,0,4,1495
9,2,11,0,0,0,4,1496
1,1,2,0,0,0,4,1497
4,1,5,0,0,0,4,1498
2,0,2,0,0,0,4,1499
23,3,26,0,0,0,4,1500
6,0,6,0,0,0,4,1501
4,0,4,0,0,0,4,1502
5,1,6,0,0,0,4,1503
5,0,5,1,0,1,4,1504
9,1,10,0,0,0,4,1505
1,0,1,0,0,0,4,1506
5,1,6,1,0,1,4,1507
11,2,13,0,0,0,4,1508
2,1,3,0,0,0,4,1509
2,0,2,0,0,0,4,1510
0,1,1,0,0,0,4,1511
5,7,12,0,0,0,4,1512
2,5,7,0,0,0,4,1513
0,0,0,0,0,0,4,1514
22,7,29,0,0,0,4,1515
0,0,0,0,0,0,4,1516
18,5,23,0,0,0,4,1517
1,0,1,0,0,0,4,1518
45,22,67,0,0,0,4,1519
2,1,3,0,0,0,4,1520
0,0,0,0,0,0,4,1521
3,5,8,0,0,0,4,1522
3,8,11,0,0,0,4,1523
0,0,0,0,0,0,4,1524
3,0,3,0,0,0,4,1525
2,0,2,0,0,0,4,1526
0,1,1,0,0,0,4,1527
5,8,13,0,0,0,4,1528
3,2,5,0,0,0,4,1529
0,0,0,0,0,0,4,1530
2,1,3,0,0,0,4,1531
5,1,6,0,0,0,4,1532
2,2,4,0,0,0,4,1533
2,0,2,0,0,0,4,1534
0,0,0,0,0,0,4,1535
0,0,0,0,0,0,4,1536
0,1,1,0,0,0,4,1537
2,2,4,0,0,0,4,1538
0,0,0,0,0,0,4,1539
3,2,5,0,0,0,4,1540
0,2,2,0,0,0,4,1541
2,3,5,0,0,0,4,1542
1,1,2,0,0,0,4,1543
1,1,2,0,0,0,4,1544
0,1,1,0,0,0,4,1545
1,1,2,0,0,0,4,1546
3,0,3,0,0,0,4,1547
3,0,3,1,0,1,4,1548
6,1,7,0,0,0,4,1549
25,12,37,0,0,0,4,1550
13,4,17,0,0,0,4,1551
1,0,1,0,0,0,4,1552
3,5,8,0,0,0,4,1553
1,1,2,0,0,0,4,1554
0,0,0,0,0,0,4,1555
3,1,4,0,0,0,4,1556
5,1,6,0,0,0,4,1557
1,0,1,0,0,0,4,1558
2,0,2,0,0,0,4,1559
2,1,3,0,0,0,4,1560
7,1,8,0,0,0,4,1561
2,0,2,0,0,0,4,1562
0,2,2,0,0,0,4,1563
2,0,2,0,0,0,4,1564
2,3,5,0,0,0,4,1565
6,8,14,0,0,0,4,1566
0,0,0,0,0,0,4,1567
6,1,7,0,0,0,4,1568
0,4,4,0,0,0,4,1569
0,2,2,0,0,0,4,1570
4,5,9,0,0,0,4,1571
38,34,72,0,0,0,4,1572
21,12,33,0,0,0,4,1573
7,1,8,0,0,0,4,1574
1,2,3,0,0,0,4,1575
4,4,8,0,0,0,4,1576
0,0,0,0,0,0,4,1577
1,1,2,0,0,0,4,1578
5,1,6,0,0,0,4,1579
0,0,0,0,0,0,4,1580
2,6,8,0,2,2,4,1581
0,2,2,0,0,0,4,1582
2,4,6,0,0,0,4,1583
5,6,11,0,0,0,4,1584
0,0,0,0,0,0,4,1585
1,2,3,0,0,0,4,1586
4,7,11,0,0,0,4,1587
0,1,1,0,0,0,4,1588
1,0,1,0,0,0,4,1589
0,0,0,0,0,0,4,1590
2,0,2,0,0,0,4,1591
1,0,1,0,0,0,4,1592
1,0,1,0,0,0,4,1593
2,5,7,0,0,0,4,1594
1,0,1,0,0,0,4,1595
1,7,8,0,0,0,4,1596
6,1,7,0,0,0,4,1597
3,0,3,0,0,0,4,1598
7,1,8,0,0,0,4,1599
283,89,372,0,0,0,4,1600
19,11,30,0,0,0,4,1601
37,26,63,0,0,0,4,1602
6,0,6,0,0,0,4,1603
3,0,3,1,0,1,4,1604
6,2,8,0,0,0,4,1605
2,0,2,0,0,0,4,1606
8,1,9,0,0,0,4,1607
1,4,5,0,0,0,4,1608
0,0,0,0,0,0,4,1609
2,0,2,0,0,0,4,1610
0,0,0,0,0,0,4,1611
0,0,0,0,0,0,4,1612
1,0,1,0,0,0,4,1613
6,0,6,0,0,0,4,1614
2,0,2,0,0,0,4,1615
0,0,0,0,0,0,4,1616
4,0,4,0,0,0,4,1617
4,13,17,0,0,0,4,1618
3,2,5,0,0,0,4,1619
4,3,7,0,0,0,4,1620
3,1,4,0,0,0,4,1621
3,0,3,2,0,2,4,1622
2,2,4,0,0,0,4,1623
0,0,0,0,0,0,4,1624
3,2,5,1,0,1,4,1625
4,2,6,0,0,0,4,1626
3,0,3,0,0,0,4,1627
1,7,8,0,0,0,4,1628
2,1,3,0,0,0,4,1629
2,3,5,0,0,0,4,1630
2,0,2,0,0,0,4,1631
2,0,2,0,0,0,4,1632
4,0,4,0,0,0,4,1633
3,0,3,0,0,0,4,1634
0,0,0,0,0,0,4,1635
4,3,7,0,0,0,4,1636
3,1,4,0,0,0,4,1637
1,1,2,0,0,0,4,1638
4,1,5,0,0,0,4,1639
0,0,0,0,0,0,4,1640
2,2,4,0,0,0,4,1641
0,2,2,0,0,0,4,1642
2,1,3,0,0,0,4,1643
0,0,0,0,0,0,4,1644
9,5,14,0,0,0,4,1645
0,0,0,0,0,0,4,1646
0,2,2,0,0,0,4,1647
0,0,0,0,0,0,4,1648
4,3,7,0,0,0,4,1649
8,1,9,0,0,0,4,1650
17,7,24,0,0,0,4,1651
7,2,9,0,0,0,4,1652
1,1,2,0,0,0,4,1653
1,0,1,0,0,0,4,1654
1,1,2,0,0,0,4,1655
1,0,1,0,0,0,4,1656
3,2,5,0,0,0,4,1657
0,0,0,0,0,0,4,1658
7,2,9,0,0,0,4,1659
1,3,4,0,1,1,4,1660
1,0,1,0,0,0,4,1661
2,0,2,0,0,0,4,1662
0,0,0,0,0,0,4,1663
2,0,2,0,0,0,4,1664
7,8,15,0,0,0,4,1665
2,0,2,0,0,0,4,1666
0,0,0,0,0,0,4,1667
4,1,5,0,0,0,4,1668
6,3,9,0,1,1,4,1669
6,2,8,0,0,0,4,1670
1,0,1,0,0,0,4,1671
0,0,0,0,0,0,4,1672
5,2,7,0,0,0,4,1673
5,2,7,0,0,0,4,1674
13,5,18,0,0,0,4,1675
1,0,1,0,0,0,4,1676
5,7,12,0,0,0,4,1677
2,0,2,0,0,0,4,1678
8,3,11,0,0,0,4,1679
0,0,0,0,0,0,4,1680
2,2,4,0,0,0,4,1681
1,2,3,0,0,0,4,1682
0,4,4,0,0,0,4,1683
53,85,138,0,1,1,4,1684
16,78,94,1,1,2,4,1685
1,2,3,0,0,0,4,1686
0,2,2,0,0,0,4,1687
62,49,111,0,0,0,4,1688
1,1,2,0,0,0,4,1689
0,1,1,0,0,0,4,1690
0,0,0,0,0,0,4,1691
9,3,12,0,0,0,4,1692
1,2,3,0,0,0,4,1693
1,2,3,0,0,0,4,1694
70,98,168,0,0,0,4,1695
0,0,0,0,0,0,4,1696
1,0,1,0,0,0,4,1697
2,0,2,0,0,0,4,1698
0,2,2,0,0,0,4,1699
7,11,18,0,0,0,4,1700
1,1,2,0,0,0,4,1701
0,4,4,0,0,0,4,1702
1,1,2,0,0,0,4,1703
123,67,190,2,2,4,4,1704
5,4,9,0,0,0,4,1705
3,2,5,0,0,0,4,1706
0,0,0,0,0,0,4,1707
17,16,33,0,0,0,4,1708
3,5,8,0,0,0,4,1709
0,2,2,0,0,0,4,1710
9,2,11,0,0,0,4,1711
2,1,3,0,0,0,4,1712
2,0,2,0,0,0,4,1713
2,0,2,0,0,0,4,1714
4,0,4,1,0,1,4,1715
74,36,110,0,0,0,4,1716
0,0,0,0,0,0,4,1717
0,1,1,0,0,0,4,1718
0,2,2,0,0,0,4,1719
7,2,9,0,0,0,4,1720
2,1,3,0,0,0,4,1721
10,21,31,0,0,0,4,1722
0,0,0,0,0,0,4,1723
7,1,8,1,0,1,4,1724
2,1,3,0,0,0,4,1725
3,2,5,0,0,0,4,1726
6,2,8,0,0,0,4,1727
33,8,41,0,0,0,4,1728
2,3,5,0,0,0,4,1729
0,0,0,0,0,0,4,1730
1,1,2,0,0,0,4,1731
0,0,0,0,0,0,4,1732
1,1,2,0,0,0,4,1733
3,0,3,1,0,1,4,1734
1,0,1,0,0,0,4,1735
2,2,4,0,0,0,4,1736
2,0,2,0,0,0,4,1737
4,3,7,0,0,0,4,1738
2,1,3,0,0,0,4,1739
0,1,1,0,0,0,4,1740
7,2,9,0,0,0,4,1741
6,2,8,0,0,0,4,1742
1,0,1,0,0,0,4,1743
1,0,1,0,0,0,4,1744
0,0,0,0,0,0,4,1745
1,0,1,0,0,0,4,1746
0,0,0,0,0,0,4,1747
0,1,1,0,0,0,4,1748
0,3,3,0,0,0,4,1749
0,1,1,0,0,0,4,1750
2,1,3,0,0,0,4,1751
0,0,0,0,0,0,4,1752
7,7,14,0,0,0,4,1753
109,131,240,0,0,0,4,1754
3,4,7,0,0,0,4,1755
0,0,0,-1,-1,-2,4,1756
0,1,1,0,0,0,4,1757
2,0,2,0,0,0,4,1758
5,8,13,0,0,0,4,1759
3,0,3,0,0,0,4,1760
6,2,8,0,0,0,4,1761
0,0,0,0,0,0,4,1762
1,2,3,0,0,0,4,1763
2,2,4,0,0,0,4,1764
0,1,1,0,0,0,4,1765
3,1,4,0,0,0,4,1766
2,0,2,0,0,0,4,1767
0,1,1,0,0,0,4,1768
0,0,0,0,0,0,4,1769
4,0,4,0,0,0,4,1770
12,12,24,2,0,2,4,1771
4,0,4,0,0,0,4,1772
0,2,2,0,0,0,4,1773
1,1,2,0,0,0,4,1774
12,25,37,0,0,0,4,1775
9,8,17,0,0,0,4,1776
4,1,5,0,0,0,4,1777
0,1,1,0,0,0,4,1778
3,0,3,0,0,0,4,1779
2,0,2,0,0,0,4,1780
1,2,3,0,1,1,4,1781
3,0,3,0,0,0,4,1782
1,0,1,0,0,0,4,1783
5,3,8,0,0,0,4,1784
35,13,48,0,0,0,4,1785
1,3,4,0,0,0,4,1786
7,2,9,0,0,0,4,1787
1,0,1,0,0,0,4,1788
0,0,0,0,-1,-1,4,1789
3,2,5,0,0,0,4,1790
0,4,4,0,0,0,4,1791
1,1,2,0,0,0,4,1792
0,0,0,0,0,0,4,1793
2,2,4,0,0,0,4,1794
0,0,0,0,0,0,4,1795
152,62,214,1,2,3,4,1796
4,0,4,0,0,0,4,1797
0,0,0,0,0,0,4,1798
22,3,25,0,0,0,4,1799
20,9,29,0,0,0,4,1800
1,3,4,0,0,0,4,1801
1,1,2,0,0,0,4,1802
6,1,7,0,0,0,4,1803
3,2,5,0,0,0,4,1804
16,4,20,0,0,0,4,1805
0,0,0,0,0,0,4,1806
5,5,10,0,1,1,4,1807
9,6,15,0,0,0,4,1808
0,0,0,0,0,0,4,1809
1,0,1,0,0,0,4,1810
0,2,2,0,1,1,4,1811
0,0,0,0,0,0,4,1812
0,2,2,0,0,0,4,1813
6,18,24,0,0,0,4,1814
0,1,1,0,0,0,4,1815
6,7,13,0,0,0,4,1816
1,0,1,0,0,0,4,1817
3,1,4,0,0,0,4,1818
3,5,8,0,0,0,4,1819
1,3,4,0,0,0,4,1820
9,18,27,0,0,0,4,1821
0,5,5,0,0,0,4,1822
75,33,108,0,0,0,4,1823
5,1,6,0,0,0,4,1824
6,1,7,0,0,0,4,1825
8,3,11,0,0,0,4,1826
0,3,3,0,0,0,4,1827
5,1,6,0,0,0,4,1828
1,0,1,0,0,0,4,1829
11,9,20,0,0,0,4,1830
0,1,1,0,0,0,4,1831
1,0,1,0,0,0,4,1832
0,0,0,0,0,0,4,1833
5,2,7,0,0,0,4,1834
2,0,2,0,0,0,4,1835
4,1,5,0,0,0,4,1836
1,0,1,0,0,0,4,1837
2,0,2,0,0,0,4,1838
1,1,2,0,0,0,4,1839
16,12,28,0,0,0,4,1840
5,2,7,0,0,0,4,1841
1,4,5,0,0,0,4,1842
11,8,19,0,0,0,4,1843
0,0,0,0,0,0,4,1844
5,6,11,0,0,0,4,1845
0,1,1,0,0,0,4,1846
0,1,1,0,0,0,4,1847
5,0,5,0,0,0,4,1848
32,12,44,1,0,1,4,1849
1,0,1,0,0,0,4,1850
2,0,2,0,0,0,4,1851
0,0,0,0,0,0,4,1852
3,1,4,0,0,0,4,1853
7,4,11,0,0,0,4,1854
3,2,5,0,0,0,4,1855
4,0,4,0,0,0,4,1856
3,3,6,0,0,0,4,1857
10,5,15,0,0,0,4,1858
0,1,1,0,0,0,4,1859
0,0,0,0,0,0,4,1860
0,0,0,0,0,0,4,1861
1,0,1,0,0,0,4,1862
0,0,0,0,0,0,4,1863
2,0,2,0,0,0,4,1864
0,0,0,0,0,0,4,1865
1,0,1,0,0,0,4,1866
2,2,4,0,0,0,4,1867
3,1,4,0,0,0,4,1868
1,0,1,0,0,0,4,1869
19,35,54,0,0,0,4,1870
0,0,0,0,0,0,4,1871
8,3,11,0,0,0,4,1872
4,0,4,0,0,0,4,1873
2,1,3,0,0,0,4,1874
5,1,6,0,0,0,4,1875
2,0,2,1,0,1,4,1876
0,1,1,0,0,0,4,1877
1,1,2,0,0,0,4,1878
4,6,10,0,0,0,4,1879
6,1,7,0,0,0,4,1880
1,3,4,0,0,0,4,1881
4,0,4,0,0,0,4,1882
0,1,1,0,0,0,4,1883
20,11,31,0,0,0,4,1884
1,0,1,0,0,0,4,1885
0,1,1,0,0,0,4,1886
0,0,0,-27,-8,-35,4,1887
12,7,19,0,0,0,4,1888
6,3,9,0,0,0,4,1889
0,0,0,0,0,0,4,1890
7,2,9,0,0,0,4,1891
7,2,9,0,0,0,4,1892
2,3,5,0,0,0,4,1893
7,1,8,0,0,0,4,1894
2,0,2,0,0,0,4,1895
6,21,27,0,0,0,4,1896
8,1,9,0,0,0,4,1897
1,1,2,0,0,0,4,1898
1,3,4,0,0,0,4,1899
4,3,7,0,0,0,4,1900
4,3,7,0,0,0,4,1901
0,0,0,0,0,0,4,1902
0,0,0,0,0,0,4,1903
11,13,24,0,0,0,4,1904
1,0,1,0,0,0,4,1905
3,1,4,0,0,0,4,1906
4,0,4,0,0,0,4,1907
1,6,7,0,0,0,4,1908
1,1,2,0,0,0,4,1909
0,1,1,0,0,0,4,1910
2,3,5,0,0,0,4,1911
2,0,2,0,0,0,4,1912
6,1,7,0,0,0,4,1913
11,0,11,0,0,0,4,1914
5,0,5,0,0,0,4,1915
3,0,3,0,0,0,4,1916
3,1,4,0,0,0,4,1917
4,12,16,0,0,0,4,1918
59,24,83,0,1,1,4,1919
1,1,2,0,0,0,4,1920
2,5,7,0,0,0,4,1921
4,0,4,1,0,1,4,1922
16,9,25,0,0,0,4,1923
65,45,110,0,0,0,4,1924
7,2,9,0,0,0,4,1925
1,2,3,0,0,0,4,1926
19,10,29,0,0,0,4,1927
2,0,2,0,0,0,4,1928
3,2,5,0,0,0,4,1929
3,0,3,0,0,0,4,1930
5,3,8,0,1,1,4,1931
10,3,13,0,0,0,4,1932
13,5,18,0,0,0,4,1933
1,4,5,0,0,0,4,1934
1,0,1,0,0,0,4,1935
4,4,8,0,0,0,4,1936
3,1,4,0,0,0,4,1937
10,3,13,0,0,0,4,1938
6,10,16,0,0,0,4,1939
4,2,6,0,0,0,4,1940
4,4,8,0,0,0,4,1941
15,4,19,0,0,0,4,1942
4,2,6,0,0,0,4,1943
13,5,18,0,0,0,4,1944
0,4,4,0,0,0,4,1945
2,4,6,0,0,0,4,1946
2,4,6,0,0,0,4,1947
7,6,13,0,0,0,4,1948
1,4,5,0,0,0,4,1949
12,10,22,1,0,1,4,1950
39,30,69,1,1,2,4,1951
15,11,26,0,0,0,4,1952
0,0,0,0,0,0,4,1953
0,0,0,0,0,0,4,1954
1,1,2,0,0,0,4,1955
3,4,7,0,0,0,4,1956
7,2,9,0,0,0,4,1957
2,5,7,0,0,0,4,1958
2,1,3,0,0,0,4,1959
2,0,2,0,0,0,4,1960
1,1,2,0,0,0,4,1961
1,0,1,0,0,0,4,1962
2,4,6,0,0,0,4,1963
2,1,3,0,0,0,4,1964
0,0,0,0,0,0,4,1965
11,6,17,0,1,1,4,1966
1,0,1,0,0,0,4,1967
1,0,1,0,0,0,4,1968
3,5,8,0,0,0,4,1969
0,2,2,0,0,0,4,1970
0,0,0,0,0,0,4,1971
80,23,103,0,0,0,4,1972
6,0,6,0,0,0,4,1973
6,3,9,0,0,0,4,1974
0,0,0,0,0,0,4,1975
7,0,7,0,0,0,4,1976
2,4,6,0,0,0,4,1977
15,23,38,0,0,0,4,1978
2402,3287,5689,21,41,62,4,1979
1221,2176,3397,4,9,13,4,1980
181,109,290,2,1,3,4,1981
532,1504,2036,9,24,33,4,1982
950,2756,3706,2,11,13,4,1983
30,58,88,0,1,1,4,1984
15,31,46,0,0,0,4,1985
1308,1254,2562,13,11,24,4,1986
2264,5156,7420,15,26,41,4,1987
14,5,19,0,0,0,4,1988
130,64,194,2,2,4,4,1989
329,241,570,1,0,1,4,1990
62,9,71,0,1,1,4,1991
79,96,175,1,2,3,4,1992
78,149,227,4,3,7,4,1993
192,260,452,0,2,2,4,1994
373,289,662,6,3,9,4,1995
62,74,136,0,0,0,4,1996
123,189,312,1,4,5,4,1997
7,16,23,0,2,2,4,1998
6,16,22,0,0,0,4,1999
17,11,28,0,0,0,4,2000
32,2,34,0,0,0,4,2001
4,2,6,0,0,0,4,2002
38,4,42,0,0,0,4,2003
12,7,19,0,0,0,4,2004
3,6,9,0,0,0,4,2005
0,2,2,0,0,0,4,2006
0,0,0,0,0,0,4,2007
2,1,3,0,0,0,4,2008
19,15,34,0,1,1,4,2009
3,3,6,0,0,0,4,2010
0,2,2,0,0,0,4,2011
1,0,1,0,0,0,4,2012
1,6,7,0,0,0,4,2013
3225,3129,6354,15,12,27,4,2014
467,516,983,4,6,10,4,2015
250,190,440,2,0,2,4,2016
221,182,403,0,2,2,4,2017
83,56,139,0,0,0,4,2018
0,0,0,0,0,0,4,2019
14,9,23,0,0,0,4,2020
60,38,98,0,0,0,4,2021
139,197,336,1,2,3,4,2022
0,0,0,0,0,0,4,2023
195,175,370,3,2,5,4,2024
407,350,757,10,7,17,4,2025
16,6,22,0,0,0,4,2026
11,9,20,0,0,0,4,2027
1,2,3,0,0,0,4,2028
0,2,2,0,0,0,4,2029
130,42,172,1,1,2,4,2030
15,5,20,0,0,0,4,2031
12,7,19,1,0,1,4,2032
1,4,5,0,0,0,4,2033
60,108,168,0,0,0,4,2034
35,21,56,0,0,0,4,2035
20,13,33,0,0,0,4,2036
4,2,6,0,0,0,4,2037
9,6,15,0,0,0,4,2038
6,8,14,0,0,0,4,2039
2,2,4,0,0,0,4,2040
25,12,37,0,0,0,4,2041
2,2,4,0,0,0,4,2042
21,23,44,0,0,0,4,2043
2346,5350,7696,31,38,69,4,2044
70,55,125,0,1,1,4,2045
9,7,16,0,0,0,4,2046
1,2,3,0,0,0,4,2047
2,0,2,0,0,0,4,2048
3,1,4,0,0,0,4,2049
2,2,4,0,0,0,4,2050
0,4,4,0,0,0,4,2051
464,482,946,21,16,37,4,2052
103,92,195,1,3,4,4,2053
124,178,302,12,8,20,4,2054
148,217,365,3,2,5,4,2055
581,411,992,26,16,42,4,2056
25,23,48,0,1,1,4,2057
0,0,0,0,0,0,4,2058
5,1,6,0,0,0,4,2059
1,4,5,0,0,0,4,2060
0,1,1,0,0,0,4,2061
4,0,4,0,0,0,4,2062
15,45,60,1,0,1,4,2063
0,1,1,0,0,0,4,2064
2,2,4,0,0,0,4,2065
13,3,16,0,0,0,4,2066
6,8,14,0,0,0,4,2067
41,107,148,1,1,2,4,2068
12,22,34,0,1,1,4,2069
0,1,1,0,0,0,4,2070
4,4,8,0,0,0,4,2071
1,2,3,0,0,0,4,2072
0,2,2,0,0,0,4,2073
93,418,511,2,5,7,4,2074
1,2,3,0,0,0,4,2075
2,0,2,0,0,0,4,2076
0,0,0,0,0,0,4,2077
0,4,4,0,0,0,4,2078
11,5,16,0,0,0,4,2079
17,36,53,0,0,0,4,2080
6824,12114,18938,60,64,124,4,2081
0,0,0,0,0,0,4,2082
0,1,1,0,0,0,4,2083
0,0,0,0,0,0,4,2084
0,1,1,0,0,0,4,2085
0,0,0,0,0,0,4,2086
0,1,1,0,0,0,4,2087
9,13,22,0,0,0,4,2088
1,0,1,0,0,0,4,2089
2,12,14,0,0,0,4,2090
1,2,3,0,0,0,4,2091
2,4,6,0,0,0,4,2092
0,0,0,0,0,0,4,2093
0,2,2,0,0,0,4,2094
0,0,0,0,0,0,4,2095
0,0,0,0,0,0,4,2096
0,1,1,0,0,0,4,2097
0,0,0,0,0,0,4,2098
0,1,1,0,0,0,4,2099
1,4,5,0,0,0,4,2100
2,0,2,0,0,0,4,2101
0,0,0,0,0,0,4,2102
1,0,1,0,0,0,4,2103
0,0,0,0,0,0,4,2104
3,5,8,0,0,0,4,2105
0,0,0,0,0,0,4,2106
0,1,1,0,0,0,4,2107
1,0,1,0,0,0,4,2108
0,1,1,0,0,0,4,2109
2,5,7,0,2,2,4,2110
5,34,39,0,2,2,4,2111
0,0,0,0,0,0,4,2112
0,0,0,0,0,0,4,2113
1,1,2,0,0,0,4,2114
0,0,0,0,0,0,4,2115
0,0,0,0,0,0,4,2116
2,2,4,0,0,0,4,2117
0,0,0,0,0,0,4,2118
0,0,0,0,0,0,4,2119
1,0,1,0,0,0,4,2120
0,0,0,0,0,0,4,2121
0,1,1,0,0,0,4,2122
0,0,0,0,0,0,4,2123
1,0,1,0,0,0,4,2124
0,2,2,0,0,0,4,2125
0,0,0,0,0,0,4,2126
0,0,0,0,0,0,4,2127
0,0,0,0,0,0,4,2128
0,2,2,0,0,0,4,2129
0,2,2,0,0,0,4,2130
0,0,0,0,0,0,4,2131
0,1,1,0,0,0,4,2132
0,1,1,0,0,0,4,2133
0,0,0,0,0,0,4,2134
0,0,0,0,0,0,4,2135
2,2,4,0,0,0,4,2136
1,0,1,0,0,0,4,2137
0,1,1,0,0,0,4,2138
0,0,0,0,0,0,4,2139
0,0,0,0,0,0,4,2140
40,31,71,0,0,0,4,2141
143,112,255,1,2,3,4,2142
16,5,21,0,0,0,4,2143
5,3,8,0,0,0,4,2144
23,7,30,0,0,0,4,2145
15,4,19,0,0,0,4,2146
48,57,105,0,1,1,4,2147
29,55,84,0,1,1,4,2148
11,32,43,0,0,0,4,2149
261,465,726,4,7,11,4,2150
87,188,275,2,0,2,4,2151
25,57,82,1,0,1,4,2152
49,25,74,0,0,0,4,2153
127,115,242,2,0,2,4,2154
88,90,178,0,1,1,4,2155
13,12,25,0,1,1,4,2156
13,16,29,0,0,0,4,2157
1,6,7,0,0,0,4,2158
11,5,16,0,0,0,4,2159
18,8,26,0,0,0,4,2160
12,17,29,0,0,0,4,2161
78,59,137,1,0,1,4,2162
29,17,46,0,0,0,4,2163
66,154,220,1,0,1,4,2164
39,42,81,1,0,1,4,2165
95,86,181,0,1,1,4,2166
80,46,126,2,1,3,4,2167
52,22,74,0,0,0,4,2168
33,4,37,0,0,0,4,2169
5,1,6,0,0,0,4,2170
8,13,21,0,0,0,4,2171
0,0,0,-477,-520,-997,4,2172
10,4,14,0,0,0,4,2173
11,50,61,0,0,0,4,2174
14,1,15,0,0,0,4,2175
26,7,33,1,0,1,4,2176
3,2,5,0,0,0,4,2177
59,10,69,0,0,0,4,2178
1,0,1,0,0,0,4,2179
1,0,1,0,0,0,4,2180
2,2,4,0,0,0,4,2181
6,3,9,0,0,0,4,2182
2,2,4,0,0,0,4,2183
4,2,6,0,0,0,4,2184
0,1,1,0,0,0,4,2185
8,8,16,0,0,0,4,2186
0,6,6,0,0,0,4,2187
12,7,19,0,0,0,4,2188
4,1,5,0,0,0,4,2189
4,3,7,0,0,0,4,2190
5,7,12,0,0,0,4,2191
3,1,4,0,0,0,4,2192
0,3,3,0,0,0,4,2193
2,7,9,0,0,0,4,2194
10,1,11,0,0,0,4,2195
3,3,6,0,0,0,4,2196
12,6,18,0,0,0,4,2197
47,30,77,0,0,0,4,2198
95,44,139,0,0,0,4,2199
648,244,892,2,0,2,4,2200
90,33,123,1,0,1,4,2201
10,3,13,0,0,0,4,2202
1,0,1,0,0,0,4,2203
12,3,15,0,0,0,4,2204
5,4,9,0,0,0,4,2205
0,0,0,0,0,0,4,2206
4,1,5,0,0,0,4,2207
0,1,1,0,0,0,4,2208
2,0,2,0,0,0,4,2209
7,2,9,0,0,0,4,2210
6,6,12,0,0,0,4,2211
3,2,5,0,0,0,4,2212
16,15,31,0,0,0,4,2213
8,5,13,0,0,0,4,2214
0,3,3,0,0,0,4,2215
3,0,3,0,0,0,4,2216
2,0,2,0,0,0,4,2217
2,2,4,0,0,0,4,2218
1,2,3,0,0,0,4,2219
1,0,1,0,0,0,4,2220
0,9,9,0,0,0,4,2221
7,1,8,0,0,0,4,2222
5,0,5,0,0,0,4,2223
2,5,7,0,0,0,4,2224
0,1,1,0,0,0,4,2225
2,1,3,0,0,0,4,2226
1,3,4,0,0,0,4,2227
17,3,20,0,0,0,4,2228
6,2,8,0,0,0,4,2229
1,1,2,0,0,0,4,2230
4,17,21,0,0,0,4,2231
1,1,2,0,0,0,4,2232
9,1,10,0,0,0,4,2233
1,0,1,0,0,0,4,2234
5,1,6,0,0,0,4,2235
4,1,5,0,0,0,4,2236
1,3,4,0,0,0,4,2237
1,0,1,0,0,0,4,2238
2,0,2,0,0,0,4,2239
0,1,1,0,0,0,4,2240
1,0,1,0,0,0,4,2241
0,0,0,0,0,0,4,2242
5,6,11,0,0,0,4,2243
0,1,1,0,0,0,4,2244
2,1,3,0,0,0,4,2245
4,0,4,0,0,0,4,2246
4,16,20,0,0,0,4,2247
1,1,2,0,0,0,4,2248
7,1,8,0,0,0,4,2249
4691,9814,14505,15,40,55,4,2250
5,8,13,0,0,0,4,2251
4,3,7,0,0,0,4,2252
0,0,0,0,0,0,4,2253
1,0,1,0,0,0,4,2254
3,3,6,0,0,0,4,2255
0,0,0,0,0,0,4,2256
239,111,350,3,0,3,4,2257
2,9,11,0,1,1,4,2258
3,1,4,0,0,0,4,2259
1,2,3,0,0,0,4,2260
2,0,2,0,0,0,4,2261
2,0,2,0,0,0,4,2262
1,1,2,0,0,0,4,2263
1,0,1,0,0,0,4,2264
0,1,1,0,0,0,4,2265
0,0,0,0,0,0,4,2266
1,0,1,0,0,0,4,2267
0,1,1,0,0,0,4,2268
3,2,5,0,0,0,4,2269
1,4,5,0,0,0,4,2270
1,6,7,0,0,0,4,2271
0,0,0,0,0,0,4,2272
1,0,1,0,0,0,4,2273
16,1,17,1,0,1,4,2274
1,2,3,0,0,0,4,2275
2,5,7,0,0,0,4,2276
0,0,0,0,0,0,4,2277
20,38,58,0,1,1,4,2278
3,2,5,0,0,0,4,2279
12,38,50,0,0,0,4,2280
0,0,0,0,0,0,4,2281
4,0,4,0,0,0,4,2282
0,0,0,0,0,0,4,2283
1,2,3,0,0,0,4,2284
2,1,3,0,0,0,4,2285
1,1,2,0,0,0,4,2286
0,0,0,0,0,0,4,2287
1,0,1,0,0,0,4,2288
3,0,3,0,0,0,4,2289
0,0,0,0,0,0,4,2290
1,0,1,0,0,0,4,2291
4,0,4,0,0,0,4,2292
2,0,2,0,0,0,4,2293
1,1,2,0,0,0,4,2294
0,1,1,0,0,0,4,2295
32,30,62,0,0,0,4,2296
0,0,0,0,0,0,4,2297
141,125,266,1,0,1,4,2298
80,67,147,2,0,2,4,2299
83,48,131,3,0,3,4,2300
8,4,12,0,0,0,4,2301
2,7,9,0,0,0,4,2302
11,3,14,0,0,0,4,2303
4,0,4,0,0,0,4,2304
5,0,5,0,0,0,4,2305
1,3,4,0,0,0,4,2306
0,1,1,0,0,0,4,2307
8,5,13,0,0,0,4,2308
1,1,2,1,0,1,4,2309
1,0,1,0,0,0,4,2310
0,3,3,0,0,0,4,2311
0,0,0,0,0,0,4,2312
0,0,0,0,0,0,4,2313
1,0,1,0,0,0,4,2314
3,0,3,0,0,0,4,2315
44,42,86,0,0,0,4,2316
23,43,66,0,0,0,4,2317
82,179,261,2,4,6,4,2318
3,1,4,0,0,0,4,2319
16,3,19,0,0,0,4,2320
28,5,33,0,0,0,4,2321
1626,1729,3355,8,15,23,4,2322
12,3,15,0,0,0,4,2323
14,4,18,0,0,0,4,2324
8,5,13,0,0,0,4,2325
22,17,39,0,1,1,4,2326
30,12,42,0,0,0,4,2327
19,3,22,0,0,0,4,2328
846,659,1505,2,6,8,4,2329
4148,2380,6528,3,5,8,4,2330
0,4,4,0,0,0,4,2331
49,157,206,1,0,1,4,2332
3,7,10,0,0,0,4,2333
8,26,34,0,2,2,4,2334
2,16,18,0,0,0,4,2335
14,114,128,1,0,1,4,2336
5,23,28,0,2,2,4,2337
223,110,333,0,0,0,4,2338
123,107,230,2,1,3,4,2339
18,10,28,0,0,0,4,2340
17,34,51,1,1,2,4,2341
326,83,409,4,2,6,4,2342
359,101,460,2,0,2,4,2343
129,24,153,1,0,1,4,2344
7,6,13,0,0,0,4,2345
17,6,23,0,0,0,4,2346
13,0,13,0,0,0,4,2347
11,11,22,0,1,1,4,2348
8,4,12,0,0,0,4,2349
12,10,22,0,0,0,4,2350
49,22,71,0,0,0,4,2351
3,0,3,0,0,0,4,2352
94,43,137,0,0,0,4,2353
15,25,40,0,1,1,4,2354
17,9,26,0,0,0,4,2355
8,16,24,0,0,0,4,2356
33,3,36,0,0,0,4,2357
4,3,7,0,0,0,4,2358
3,0,3,0,0,0,4,2359
9,1,10,0,0,0,4,2360
1,2,3,0,0,0,4,2361
37,5,42,0,0,0,4,2362
1550,677,2227,17,3,20,4,2363
799,1090,1889,14,11,25,4,2364
12,9,21,0,0,0,4,2365
11,25,36,0,0,0,4,2366
3,1,4,0,0,0,4,2367
39,2,41,0,0,0,4,2368
140,248,388,5,8,13,4,2369
2,6,8,0,0,0,4,2370
4,2,6,0,0,0,4,2371
29,4,33,0,0,0,4,2372
20,2,22,0,0,0,4,2373
77,32,109,0,0,0,4,2374
41,11,52,0,0,0,4,2375
9,2,11,0,0,0,4,2376
10,3,13,0,0,0,4,2377
9,0,9,0,0,0,4,2378
8,7,15,0,0,0,4,2379
2,2,4,0,0,0,4,2380
16,6,22,1,0,1,4,2381
8,4,12,0,0,0,4,2382
41,96,137,0,0,0,4,2383
77,159,236,3,2,5,4,2384
0,0,0,0,0,0,4,2385
0,0,0,0,0,0,4,2386
0,0,0,0,0,0,4,2387
0,0,0,0,0,0,4,2388
0,0,0,0,0,0,4,2389
16,12,28,0,0,0,4,2390
1,1,2,0,0,0,4,2391
0,0,0,0,0,0,4,2392
2,0,2,0,0,0,4,2393
1,5,6,0,0,0,4,2394
1,1,2,0,0,0,4,2395
1,0,1,0,0,0,4,2396
4,3,7,0,0,0,4,2397
3,8,11,0,0,0,4,2398
4,7,11,0,1,1,4,2399
9,34,43,1,0,1,4,2400
9,1,10,0,0,0,4,2401
1,1,2,0,0,0,4,2402
2,2,4,0,0,0,4,2403
13,6,19,0,0,0,4,2404
44,59,103,0,0,0,4,2405
10,7,17,0,0,0,4,2406
10,11,21,0,0,0,4,2407
818,504,1322,0,3,3,4,2408
2,0,2,0,0,0,4,2409
0,3,3,0,0,0,4,2410
7,6,13,0,0,0,4,2411
0,0,0,0,0,0,4,2412
12,20,32,0,1,1,4,2413
23,24,47,0,1,1,4,2414
2,6,8,0,0,0,4,2415
2,3,5,0,0,0,4,2416
1,5,6,0,0,0,4,2417
0,14,14,0,0,0,4,2418
2,1,3,0,0,0,4,2419
0,0,0,0,0,0,4,2420
6,3,9,0,0,0,4,2421
3,6,9,0,0,0,4,2422
1,0,1,0,0,0,4,2423
1,0,1,0,0,0,4,2424
0,0,0,0,0,0,4,2425
0,4,4,0,0,0,4,2426
2,13,15,0,1,1,4,2427
0,0,0,0,0,0,4,2428
150,139,289,0,1,1,4,2429
3,2,5,0,0,0,4,2430
6,2,8,0,0,0,4,2431
27,7,34,2,2,4,4,2432
25,17,42,0,1,1,4,2433
3,1,4,0,0,0,4,2434
0,1,1,0,0,0,4,2435
2,2,4,0,0,0,4,2436
2,6,8,0,0,0,4,2437
2,6,8,0,0,0,4,2438
1,0,1,0,0,0,4,2439
1,0,1,0,0,0,4,2440
21,117,138,0,2,2,4,2441
0,1,1,0,0,0,4,2442
1,11,12,0,0,0,4,2443
4,6,10,0,0,0,4,2444
2,0,2,0,0,0,4,2445
96,40,136,0,0,0,4,2446
18,15,33,0,0,0,4,2447
16,21,37,0,0,0,4,2448
14,12,26,1,0,1,4,2449
27,11,38,0,0,0,4,2450
33,7,40,1,0,1,4,2451
0,0,0,0,0,0,4,2452
0,0,0,0,0,0,4,2453
15,0,15,0,0,0,4,2454
52,7,59,2,0,2,4,2455
20,11,31,0,0,0,4,2456
8061,6338,14399,153,114,267,4,2457
8,1,9,0,0,0,4,2458
299,665,964,4,4,8,4,2459
42,8,50,0,0,0,4,2460
15,3,18,1,0,1,4,2461
9,3,12,0,0,0,4,2462
2,5,7,0,1,1,4,2463
2,2,4,0,0,0,4,2464
13,6,19,0,0,0,4,2465
33,16,49,0,0,0,4,2466
4,12,16,0,0,0,4,2467
13,5,18,0,0,0,4,2468
0,1,1,0,0,0,4,2469
0,2,2,0,0,0,4,2470
1,0,1,0,0,0,4,2471
2,2,4,0,0,0,4,2472
0,2,2,0,0,0,4,2473
1,1,2,0,0,0,4,2474
4,0,4,0,0,0,4,2475
11,16,27,0,0,0,4,2476
198,80,278,2,2,4,4,2477
5,4,9,0,0,0,4,2478
9,8,17,0,1,1,4,2479
8,4,12,0,0,0,4,2480
33,8,41,0,0,0,4,2481
23,11,34,0,1,1,4,2482
1,1,2,0,0,0,4,2483
0,1,1,0,0,0,4,2484
0,0,0,0,0,0,4,2485
0,0,0,0,0,0,4,2486
3,0,3,0,0,0,4,2487
1,2,3,0,0,0,4,2488
0,1,1,0,0,0,4,2489
0,0,0,0,0,0,4,2490
1,0,1,0,0,0,4,2491
0,1,1,0,0,0,4,2492
1,0,1,0,0,0,4,2493
1,1,2,0,0,0,4,2494
0,0,0,0,0,0,4,2495
17,5,22,0,0,0,4,2496
6,1,7,0,0,0,4,2497
31,10,41,1,0,1,4,2498
3,1,4,0,0,0,4,2499
4,4,8,0,0,0,4,2500
0,1,1,0,0,0,4,2501
6,9,15,0,0,0,4,2502
6993,9211,16204,15,8,23,4,2503
2,3,5,0,0,0,4,2504
0,1,1,0,0,0,4,2505
6,2,8,0,0,0,4,2506
1,0,1,0,0,0,4,2507
0,1,1,0,0,0,4,2508
2,2,4,0,0,0,4,2509
1,0,1,0,0,0,4,2510
5,2,7,0,0,0,4,2511
2,0,2,0,0,0,4,2512
3,1,4,0,0,0,4,2513
2,0,2,0,0,0,4,2514
3,0,3,0,0,0,4,2515
2,0,2,0,0,0,4,2516
99,45,144,0,3,3,4,2517
136,267,403,3,4,7,4,2518
40,15,55,0,0,0,4,2519
6,5,11,0,0,0,4,2520
1,0,1,0,0,0,4,2521
0,1,1,0,0,0,4,2522
5,3,8,0,0,0,4,2523
7,2,9,0,0,0,4,2524
3,0,3,0,0,0,4,2525
6,0,6,0,0,0,4,2526
21,58,79,0,0,0,4,2527
34,34,68,0,1,1,4,2528
6,2,8,0,0,0,4,2529
1,5,6,0,0,0,4,2530
8,11,19,0,0,0,4,2531
63,11,74,1,0,1,4,2532
3,9,12,0,0,0,4,2533
28,36,64,0,1,1,4,2534
12,8,20,0,0,0,4,2535
1,2,3,0,0,0,4,2536
1,0,1,0,0,0,4,2537
61,50,111,1,0,1,4,2538
2567,2321,4888,21,14,35,4,2539
373,192,565,3,1,4,4,2540
1,0,1,0,0,0,4,2541
4,2,6,0,0,0,4,2542
85,13,98,0,0,0,4,2543
103,45,148,4,0,4,4,2544
120,23,143,0,0,0,4,2545
30,31,61,0,0,0,4,2546
51,28,79,2,0,2,4,2547
1,5,6,0,0,0,4,2548
31,12,43,1,0,1,4,2549
25,12,37,0,1,1,4,2550
4,1,5,1,0,1,4,2551
18,15,33,0,0,0,4,2552
0,0,0,0,0,0,4,2553
0,3,3,0,0,0,4,2554
6,4,10,0,0,0,4,2555
2,2,4,0,0,0,4,2556
0,0,0,0,0,0,4,2557
443,560,1003,17,15,32,4,2558
11,3,14,0,0,0,4,2559
28,7,35,0,0,0,4,2560
6,0,6,0,0,0,4,2561
1,0,1,0,0,0,4,2562
6,1,7,0,0,0,4,2563
13,2,15,1,0,1,4,2564
7,1,8,0,0,0,4,2565
0,0,0,0,0,0,4,2566
1,0,1,0,0,0,4,2567
7,13,20,0,0,0,4,2568
13,11,24,0,0,0,4,2569
24,12,36,0,0,0,4,2570
0,0,0,0,0,0,4,2571
0,1,1,0,0,0,4,2572
47,18,65,0,0,0,4,2573
7,0,7,0,0,0,4,2574
4,1,5,0,0,0,4,2575
0,0,0,0,0,0,4,2576
1,6,7,0,0,0,4,2577
0,2,2,0,0,0,4,2578
1,0,1,0,0,0,4,2579
103,36,139,0,0,0,4,2580
22,4,26,0,0,0,4,2581
194,133,327,2,2,4,4,2582
46,3,49,0,0,0,4,2583
54,71,125,0,0,0,4,2584
1,0,1,0,0,0,4,2585
22,3,25,0,0,0,4,2586
5,2,7,0,0,0,4,2587
9,21,30,1,0,1,4,2588
10,7,17,0,0,0,4,2589
4,3,7,0,0,0,4,2590
3,2,5,0,0,0,4,2591
14,4,18,0,0,0,4,2592
9,6,15,1,0,1,4,2593
19,9,28,0,0,0,4,2594
57,23,80,1,1,2,4,2595
3,4,7,0,0,0,4,2596
7,15,22,0,0,0,4,2597
18,11,29,0,0,0,4,2598
23,10,33,0,0,0,4,2599
4,1,5,0,0,0,4,2600
1,8,9,0,0,0,4,2601
125,7,132,0,0,0,4,2602
0,0,0,0,0,0,4,2603
185,109,294,0,0,0,4,2604
187,430,617,2,3,5,4,2605
5,3,8,0,0,0,4,2606
31,31,62,1,0,1,4,2607
108,27,135,1,0,1,4,2608
63,29,92,0,0,0,4,2609
4,4,8,0,0,0,4,2610
36,24,60,1,0,1,4,2611
1,0,1,0,0,0,4,2612
13,6,19,0,0,0,4,2613
49,227,276,1,1,2,4,2614
52,24,76,0,0,0,4,2615
41,10,51,0,0,0,4,2616
111,21,132,0,0,0,4,2617
36,4,40,1,0,1,4,2618
5,5,10,0,0,0,4,2619
186,778,964,1,4,5,4,2620
18,21,39,0,0,0,4,2621
24,32,56,0,0,0,4,2622
5145,1598,6743,49,21,70,4,2623
20,9,29,0,0,0,4,2624
7,0,7,0,0,0,4,2625
6,4,10,0,0,0,4,2626
6,0,6,0,0,0,4,2627
11,7,18,0,1,1,4,2628
17,18,35,0,0,0,4,2629
36,11,47,0,0,0,4,2630
10,0,10,0,0,0,4,2631
479,527,1006,4,11,15,4,2632
2022,4569,6591,40,38,78,4,2633
478,263,741,5,1,6,4,2634
2,0,2,0,0,0,4,2635
2,1,3,0,0,0,4,2636
24,7,31,0,0,0,4,2637
21,9,30,0,0,0,4,2638
2,2,4,0,0,0,4,2639
5,3,8,0,0,0,4,2640
1153,1061,2214,5,6,11,4,2641
297,241,538,2,2,4,4,2642
1,3,4,0,0,0,4,2643
1,4,5,0,0,0,4,2644
18,8,26,0,0,0,4,2645
50,33,83,0,1,1,4,2646
1,1,2,0,0,0,4,2647
15,4,19,0,0,0,4,2648
4,0,4,0,0,0,4,2649
3,0,3,0,0,0,4,2650
4,3,7,0,0,0,4,2651
1,2,3,0,0,0,4,2652
88,81,169,0,0,0,4,2653
12,5,17,0,0,0,4,2654
4,5,9,0,0,0,4,2655
1,0,1,0,0,0,4,2656
5,4,9,0,0,0,4,2657
5,6,11,1,1,2,4,2658
0,0,0,0,0,0,4,2659
53,17,70,0,0,0,4,2660
8816,3911,12727,1,2,3,4,2661
0,0,0,0,0,0,4,2662
37,52,89,0,0,0,4,2663
794,162,956,14,2,16,4,2664
25,7,32,0,3,3,4,2665
9,0,9,0,0,0,4,2666
7,5,12,0,0,0,4,2667
301,151,452,4,2,6,4,2668
3,0,3,0,0,0,4,2669
426,72,498,5,1,6,4,2670
10,0,10,1,0,1,4,2671
6,1,7,0,0,0,4,2672
8,8,16,0,0,0,4,2673
15,5,20,1,0,1,4,2674
9,1,10,0,0,0,4,2675
38,9,47,0,1,1,4,2676
36,6,42,1,0,1,4,2677
322,70,392,0,0,0,4,2678
113,406,519,0,2,2,4,2679
2425,4940,7365,21,27,48,4,2680
33,83,116,0,1,1,4,2681
3,5,8,0,0,0,4,2682
32,8,40,0,0,0,4,2683
71,54,125,0,0,0,4,2684
27,2,29,0,0,0,4,2685
0,0,0,0,0,0,4,2686
1,1,2,0,0,0,4,2687
2,2,4,0,0,0,4,2688
3,1,4,0,0,0,4,2689
8,6,14,0,0,0,4,2690
2,0,2,0,0,0,4,2691
2,3,5,0,0,0,4,2692
1,4,5,0,0,0,4,2693
0,1,1,0,0,0,4,2694
1,2,3,0,0,0,4,2695
5,4,9,0,0,0,4,2696
2,0,2,0,0,0,4,2697
0,1,1,0,0,0,4,2698
5,2,7,0,0,0,4,2699
3,2,5,0,0,0,4,2700
30,15,45,1,0,1,4,2701
3,1,4,0,0,0,4,2702
4,3,7,0,0,0,4,2703
126,197,323,0,1,1,4,2704
17197,16968,34165,6,4,10,4,2705
22,14,36,0,0,0,4,2706
33,22,55,0,0,0,4,2707
2632,2491,5123,9,5,14,4,2708
9,4,13,0,0,0,4,2709
7,5,12,0,0,0,4,2710
5,5,10,0,0,0,4,2711
4,5,9,0,0,0,4,2712
36,17,53,0,0,0,4,2713
52,29,81,1,0,1,4,2714
2,4,6,0,0,0,4,2715
1,0,1,0,0,0,4,2716
70,42,112,3,0,3,4,2717
2,1,3,0,0,0,4,2718
3,6,9,0,0,0,4,2719
3,0,3,0,0,0,4,2720
79,217,296,0,3,3,4,2721
43,32,75,0,0,0,4,2722
1427,4422,5849,5,8,13,4,2723
73,549,622,0,1,1,4,2724
52,20,72,0,0,0,4,2725
42,24,66,1,2,3,4,2726
20,6,26,0,0,0,4,2727
1,0,1,0,0,0,4,2728
346,359,705,2,2,4,4,2729
50,41,91,0,0,0,4,2730
24,5,29,0,0,0,4,2731
85,18,103,0,0,0,4,2732
86,28,114,0,1,1,4,2733
10,9,19,0,0,0,4,2734
4,3,7,0,0,0,4,2735
215,685,900,3,3,6,4,2736
29,25,54,1,0,1,4,2737
2,5,7,0,0,0,4,2738
4,1,5,0,0,0,4,2739
0,2,2,0,0,0,4,2740
0,1,1,0,0,0,4,2741
1,0,1,0,0,0,4,2742
61,18,79,0,0,0,4,2743
74,153,227,3,6,9,4,2744
271,830,1101,4,13,17,4,2745
0,0,0,0,0,0,4,2746
525,164,689,0,0,0,4,2747
401,187,588,3,0,3,4,2748
42,79,121,2,1,3,4,2749
0,0,0,0,0,0,4,2750
0,0,0,0,0,0,4,2751
2,0,2,0,0,0,4,2752
0,0,0,0,0,0,4,2753
2,4,6,0,0,0,4,2754
6,1,7,0,0,0,4,2755
2,0,2,0,0,0,4,2756
17,23,40,0,0,0,4,2757
14,50,64,1,1,2,4,2758
145,17,162,1,0,1,4,2759
8,7,15,0,0,0,4,2760
2,3,5,0,0,0,4,2761
2,1,3,0,0,0,4,2762
0,3,3,0,0,0,4,2763
0,0,0,0,0,0,4,2764
0,1,1,0,0,0,4,2765
2,3,5,0,0,0,4,2766
2,0,2,0,0,0,4,2767
1,1,2,0,0,0,4,2768
10,5,15,0,0,0,4,2769
5,5,10,0,0,0,4,2770
1,0,1,0,0,0,4,2771
0,0,0,0,0,0,4,2772
2,15,17,0,0,0,4,2773
0,0,0,0,0,0,4,2774
2376,2333,4709,13,9,22,4,2775
8,4,12,0,0,0,4,2776
57,57,114,0,1,1,4,2777
21,19,40,1,0,1,4,2778
12,3,15,0,0,0,4,2779
38,50,88,3,4,7,4,2780
0,0,0,0,0,0,4,2781
5,11,16,0,1,1,4,2782
6,8,14,0,1,1,4,2783
31,59,90,2,0,2,4,2784
6,5,11,0,0,0,4,2785
27,21,48,0,0,0,4,2786
4,9,13,0,0,0,4,2787
8,8,16,0,0,0,4,2788
79,50,129,3,0,3,4,2789
0,0,0,0,0,0,4,2790
43,73,116,1,0,1,4,2791
2,3,5,0,0,0,4,2792
2,0,2,0,0,0,4,2793
2,1,3,0,0,0,4,2794
8,2,10,0,0,0,4,2795
2,9,11,0,0,0,4,2796
0,4,4,0,0,0,4,2797
2,5,7,0,0,0,4,2798
1,1,2,0,0,0,4,2799
0,2,2,0,0,0,4,2800
2,0,2,0,0,0,4,2801
3,8,11,0,0,0,4,2802
7,20,27,0,0,0,4,2803
1,1,2,0,0,0,4,2804
0,2,2,0,0,0,4,2805
0,1,1,0,1,1,4,2806
5,1,6,0,0,0,4,2807
6,5,11,0,0,0,4,2808
3,2,5,0,0,0,4,2809
1,1,2,0,0,0,4,2810
3,3,6,0,0,0,4,2811
12,5,17,0,0,0,4,2812
2,2,4,0,0,0,4,2813
14,2,16,0,0,0,4,2814
3,4,7,0,0,0,4,2815
4,0,4,0,0,0,4,2816
4,9,13,0,0,0,4,2817
0,4,4,0,0,0,4,2818
14,52,66,0,1,1,4,2819
2,2,4,0,0,0,4,2820
0,1,1,0,0,0,4,2821
3,3,6,0,0,0,4,2822
4,1,5,0,0,0,4,2823
4911,21571,26482,8,9,17,4,2824
2070,2416,4486,1,2,3,4,2825
3,2,5,0,0,0,4,2826
1,0,1,0,0,0,4,2827
32,1,33,0,0,0,4,2828
2,2,4,0,0,0,4,2829
0,0,0,0,0,0,4,2830
1,0,1,0,0,0,4,2831
0,1,1,0,0,0,4,2832
1,0,1,0,0,0,4,2833
0,3,3,0,0,0,4,2834
4,2,6,0,0,0,4,2835
5,3,8,0,0,0,4,2836
1,0,1,0,0,0,4,2837
0,0,0,0,0,0,4,2838
15,5,20,1,1,2,4,2839
11,7,18,0,0,0,4,2840
11,2,13,0,0,0,4,2841
15,9,24,0,0,0,4,2842
2,1,3,0,0,0,4,2843
5,0,5,0,0,0,4,2844
0,0,0,0,0,0,4,2845
7,3,10,0,0,0,4,2846
2,6,8,0,0,0,4,2847
16,52,68,0,1,1,4,2848
9,7,16,0,0,0,4,2849
28,91,119,2,1,3,4,2850
21,20,41,0,0,0,4,2851
0,1,1,0,0,0,4,2852
81,259,340,0,0,0,4,2853
26,36,62,1,3,4,4,2854
26,31,57,0,0,0,4,2855
39,107,146,1,0,1,4,2856
18,33,51,2,8,10,4,2857
21,17,38,1,0,1,4,2858
17,8,25,0,0,0,4,2859
31,66,97,8,14,22,4,2860
7,17,24,3,5,8,4,2861
8,3,11,0,0,0,4,2862
1,1,2,0,0,0,4,2863
0,0,0,0,0,0,4,2864
2,3,5,0,0,0,4,2865
0,0,0,0,0,0,4,2866
4,4,8,1,0,1,4,2867
0,1,1,0,0,0,4,2868
53,262,315,0,1,1,4,2869
1,0,1,0,0,0,4,2870
4,1,5,0,0,0,4,2871
49,39,88,1,0,1,4,2872
1,1,2,0,0,0,4,2873
5,10,15,0,0,0,4,2874
30,14,44,0,1,1,4,2875
2,2,4,0,0,0,4,2876
28,27,55,1,0,1,4,2877
18,7,25,1,0,1,4,2878
76,151,227,5,2,7,4,2879
9,50,59,0,0,0,4,2880
107,79,186,0,0,0,4,2881
44,104,148,0,1,1,4,2882
0,0,0,0,0,0,4,2883
28,17,45,0,0,0,4,2884
241,116,357,3,3,6,4,2885
12,28,40,0,0,0,4,2886
26,42,68,0,0,0,4,2887
87,32,119,1,0,1,4,2888
2173,808,2981,22,9,31,4,2889
33,97,130,0,2,2,4,2890
10,26,36,1,0,1,4,2891
26,82,108,0,1,1,4,2892
35,119,154,0,0,0,4,2893
194,731,925,1,4,5,4,2894
12,6,18,0,0,0,4,2895
0,0,0,0,0,0,4,2896
7,6,13,1,0,1,4,2897
6,16,22,0,1,1,4,2898
3,4,7,0,0,0,4,2899
126,228,354,4,3,7,4,2900
118,89,207,2,0,2,4,2901
10,14,24,0,0,0,4,2902
1,2,3,0,0,0,4,2903
0,3,3,0,0,0,4,2904
10,49,59,0,0,0,4,2905
0,0,0,0,0,0,4,2906
29,103,132,0,2,2,4,2907
4,4,8,0,0,0,4,2908
6,3,9,0,0,0,4,2909
11,53,64,0,1,1,4,2910
0,2,2,0,0,0,4,2911
33,147,180,0,0,0,4,2912
9,5,14,0,0,0,4,2913
6,1,7,0,0,0,4,2914
1,0,1,0,0,0,4,2915
2,0,2,0,0,0,4,2916
24,24,48,0,1,1,4,2917
6,2,8,0,0,0,4,2918
4,4,8,0,0,0,4,2919
2,2,4,0,0,0,4,2920
30,104,134,0,3,3,4,2921
5,3,8,1,0,1,4,2922
1,4,5,0,0,0,4,2923
1,0,1,0,0,0,4,2924
1,7,8,0,0,0,4,2925
16,23,39,0,0,0,4,2926
11,3,14,0,0,0,4,2927
1,6,7,0,0,0,4,2928
742,450,1192,8,4,12,4,2929
67,99,166,0,4,4,4,2930
0,3,3,0,0,0,4,2931
3,8,11,0,0,0,4,2932
166,197,363,1,2,3,4,2933
1,6,7,0,0,0,4,2934
3,0,3,0,0,0,4,2935
832,358,1190,1,0,1,4,2936
6,8,14,0,0,0,4,2937
1,6,7,0,0,0,4,2938
9,0,9,0,0,0,4,2939
39,8,47,2,0,2,4,2940
7,7,14,0,0,0,4,2941
1,1,2,0,0,0,4,2942
4,2,6,0,0,0,4,2943
2,3,5,0,0,0,4,2944
3,2,5,0,0,0,4,2945
197,23,220,3,0,3,4,2946
536,68,604,8,0,8,4,2947
20,2,22,0,0,0,4,2948
3,0,3,0,0,0,4,2949
0,0,0,0,0,0,4,2950
11,1,12,0,0,0,4,2951
142,230,372,1,1,2,4,2952
13,80,93,1,4,5,4,2953
22,11,33,1,0,1,4,2954
47,45,92,0,0,0,4,2955
15,10,25,0,1,1,4,2956
19,14,33,1,0,1,4,2957
0,0,0,0,0,0,4,2958
70,90,160,1,1,2,4,2959
206,253,459,4,4,8,4,2960
9,7,16,0,0,0,4,2961
17,16,33,0,0,0,4,2962
8,5,13,0,0,0,4,2963
9,4,13,0,1,1,4,2964
2,7,9,0,0,0,4,2965
0,1,1,0,0,0,4,2966
0,11,11,0,0,0,4,2967
4,2,6,0,0,0,4,2968
6647,16525,23172,91,247,338,4,2969
0,0,0,0,0,0,4,2970
2,2,4,0,0,0,4,2971
0,2,2,0,0,0,4,2972
1,1,2,0,1,1,4,2973
2,3,5,0,0,0,4,2974
6,18,24,0,0,0,4,2975
8,10,18,0,0,0,4,2976
185,1250,1435,1,6,7,4,2977
2,5,7,0,0,0,4,2978
0,5,5,0,0,0,4,2979
0,1,1,0,0,0,4,2980
1,0,1,0,0,0,4,2981
0,1,1,0,0,0,4,2982
31,50,81,1,0,1,4,2983
12,7,19,0,0,0,4,2984
1,2,3,0,0,0,4,2985
1,11,12,0,0,0,4,2986
36,61,97,1,0,1,4,2987
55,199,254,2,5,7,4,2988
38,184,222,0,0,0,4,2989
0,2,2,0,0,0,4,2990
1,1,2,0,0,0,4,2991
0,2,2,0,0,0,4,2992
55,163,218,3,5,8,4,2993
2,0,2,0,0,0,4,2994
66,38,104,1,0,1,4,2995
0,0,0,0,0,0,4,2996
0,2,2,0,0,0,4,2997
0,1,1,0,0,0,4,2998
1,7,8,0,0,0,4,2999
3,25,28,0,0,0,4,3000
11,3,14,0,0,0,4,3001
87,32,119,4,2,6,4,3002
6,0,6,0,0,0,4,3003
6,5,11,0,1,1,4,3004
14,5,19,0,1,1,4,3005
1338,5445,6783,24,77,101,4,3006
0,0,0,0,0,0,4,3007
1,0,1,0,0,0,4,3008
0,0,0,0,0,0,4,3009
0,0,0,0,0,0,4,3010
1,0,1,0,0,0,4,3011
0,0,0,0,0,0,4,3012
0,0,0,0,0,0,4,3013
2,0,2,0,0,0,4,3014
6,15,21,0,0,0,4,3015
129,262,391,3,2,5,4,3016
3,2,5,0,0,0,4,3017
0,1,1,0,0,0,4,3018
2,5,7,0,0,0,4,3019
1,0,1,0,0,0,4,3020
2,12,14,0,0,0,4,3021
1,1,2,0,0,0,4,3022
13,10,23,0,0,0,4,3023
1,0,1,0,0,0,4,3024
23,21,44,3,0,3,4,3025
7,0,7,0,0,0,4,3026
8,19,27,0,0,0,4,3027
0,2,2,0,0,0,4,3028
2,3,5,0,0,0,4,3029
2,0,2,0,0,0,4,3030
0,2,2,0,0,0,4,3031
2,3,5,0,0,0,4,3032
5,14,19,0,0,0,4,3033
2,8,10,0,0,0,4,3034
1,3,4,0,0,0,4,3035
9,5,14,0,0,0,4,3036
111,43,154,4,0,4,4,3037
130,110,240,1,1,2,4,3038
24,9,33,1,0,1,4,3039
124,315,439,1,5,6,4,3040
96,161,257,0,2,2,4,3041
21,14,35,2,1,3,4,3042
5,11,16,0,0,0,4,3043
223,357,580,7,6,13,4,3044
2,22,24,0,0,0,4,3045
0,0,0,0,0,0,4,3046
0,2,2,0,0,0,4,3047
1,0,1,0,0,0,4,3048
47,61,108,0,1,1,4,3049
147,119,266,1,1,2,4,3050
1,5,6,0,0,0,4,3051
11,4,15,0,0,0,4,3052
0,0,0,0,0,0,4,3053
0,0,0,0,0,0,4,3054
1,0,1,0,0,0,4,3055
6,2,8,0,0,0,4,3056
0,2,2,0,0,0,4,3057
29,15,44,1,0,1,4,3058
1,1,2,0,0,0,4,3059
2,1,3,1,0,1,4,3060
18,9,27,0,0,0,4,3061
15,87,102,0,2,2,4,3062
32,1,33,0,0,0,4,3063
1,0,1,0,0,0,4,3064
16,0,16,0,0,0,4,3065
4,0,4,0,0,0,4,3066
5,0,5,0,0,0,4,3067
1,0,1,0,0,0,4,3068
2,1,3,0,0,0,4,3069
1,2,3,0,0,0,4,3070
45,121,166,0,1,1,4,3071
2,3,5,0,0,0,4,3072
102,137,239,3,1,4,4,3073
22,16,38,0,0,0,4,3074
0,2,2,0,0,0,4,3075
1,0,1,0,0,0,4,3076
1,9,10,0,0,0,4,3077
1,2,3,0,0,0,4,3078
85,69,154,3,0,3,4,3079
0,0,0,0,0,0,4,3080
1,6,7,0,0,0,4,3081
4,22,26,0,0,0,4,3082
11,15,26,0,0,0,4,3083
7,0,7,0,0,0,4,3084
13,12,25,0,1,1,4,3085
10,24,34,0,0,0,4,3086
1,3,4,0,0,0,4,3087
2,0,2,0,0,0,4,3088
1,1,2,0,0,0,4,3089
2,0,2,0,0,0,4,3090
0,1,1,0,0,0,4,3091
3,1,4,0,0,0,4,3092
39,69,108,0,1,1,4,3093
20,16,36,0,0,0,4,3094
114,90,204,2,2,4,4,3095
1,1,2,0,0,0,4,3096
0,0,0,0,0,0,4,3097
7,4,11,0,0,0,4,3098
1,0,1,0,0,0,4,3099
0,0,0,0,0,0,4,3100
1,0,1,0,0,0,4,3101
9,10,19,0,0,0,4,3102
0,6,6,0,0,0,4,3103
5,13,18,0,0,0,4,3104
2,2,4,0,0,0,4,3105
0,0,0,0,0,0,4,3106
0,0,0,0,0,0,4,3107
0,0,0,0,0,0,4,3108
0,0,0,0,0,0,4,3109
0,0,0,0,0,0,4,3110
0,0,0,0,0,0,4,3111
193,376,569,2,11,13,4,3112
7,13,20,0,0,0,4,3113
2,5,7,0,0,0,4,3114
1,2,3,0,0,0,4,3115
1,4,5,1,0,1,4,3116
1,0,1,0,0,0,4,3117
3,0,3,1,0,1,4,3118
8,4,12,0,0,0,4,3119
0,2,2,0,0,0,4,3120
11,49,60,0,1,1,4,3121
29090,48523,77613,264,399,663,4,3122
53,188,241,0,0,0,4,3123
33878,51354,85232,390,256,646,4,3124
446,2361,2807,6,25,31,4,3125
7647,17302,24949,37,56,93,4,3126
49,145,194,0,0,0,4,3127
94,488,582,0,3,3,4,3128
33,86,119,1,1,2,4,3129
10887,29949,40836,31,41,72,4,3130
24,108,132,0,1,1,4,3131
0,1,1,0,0,0,4,3132
0,0,0,0,0,0,4,3133
15,23,38,2,1,3,4,3134
21,37,58,1,2,3,4,3135
79,125,204,1,4,5,4,3136
39,51,90,0,0,0,4,3137
62,164,226,4,8,12,4,3138
17,66,83,3,5,8,4,3139
95,146,241,1,3,4,4,3140
91,183,274,6,4,10,4,3141
87,252,339,0,9,9,4,3142
53,189,242,0,9,9,4,3143
34,92,126,0,0,0,4,3144
96,166,262,2,2,4,4,3145
96,183,279,2,8,10,4,3146
443,732,1175,21,22,43,4,3147
2510,9182,11692,27,53,80,4,3148
11800,44380,56180,101,394,495,4,3149
1,3,4,0,0,0,4,3150
2,1,3,0,0,0,4,3151
3,2,5,0,0,0,4,3152
1,0,1,0,0,0,4,3153
0,1,1,0,0,0,4,3154
1,3,4,0,0,0,4,3155
2,5,7,0,0,0,4,3156
12,19,31,0,1,1,4,3157
0,0,0,0,0,0,4,3158
0,7,7,0,0,0,4,3159
0,3,3,0,0,0,4,3160
2,1,3,0,0,0,4,3161
0,0,0,0,0,0,4,3162
2,5,7,0,0,0,4,3163
0,0,0,0,0,0,4,3164
0,1,1,0,0,0,4,3165
4,4,8,0,0,0,4,3166
6,1,7,0,0,0,4,3167
1,0,1,0,0,0,4,3168
0,6,6,0,0,0,4,3169
5,0,5,0,0,0,4,3170
1,0,1,0,0,0,4,3171
0,0,0,0,0,0,4,3172
28,22,50,1,0,1,4,3173
15,3,18,0,0,0,4,3174
0,1,1,0,0,0,4,3175
4,0,4,0,0,0,4,3176
23,35,58,1,3,4,4,3177
2,1,3,0,0,0,4,3178
18,14,32,0,0,0,4,3179
28,24,52,0,0,0,4,3180
3,3,6,0,0,0,4,3181
75,350,425,1,5,6,4,3182
61,223,284,2,6,8,4,3183
313,182,495,1,4,5,4,3184
21,114,135,0,3,3,4,3185
5,21,26,0,0,0,4,3186
22,87,109,0,2,2,4,3187
0,1,1,0,0,0,4,3188
13,104,117,0,1,1,4,3189
2,10,12,0,0,0,4,3190
2,2,4,0,0,0,4,3191
1,2,3,0,0,0,4,3192
32,15,47,0,0,0,4,3193
19,17,36,0,0,0,4,3194
2,2,4,0,1,1,4,3195
2,0,2,0,0,0,4,3196
2,7,9,0,0,0,4,3197
0,0,0,0,0,0,4,3198
12,20,32,1,0,1,4,3199
0,0,0,0,0,0,4,3200
9,13,22,0,1,1,4,3201
0,1,1,0,0,0,4,3202
0,0,0,0,0,0,4,3203
24,27,51,0,0,0,4,3204
93,92,185,1,6,7,4,3205
81,72,153,1,0,1,4,3206
8,20,28,0,0,0,4,3207
93,160,253,2,5,7,4,3208
7,12,19,0,1,1,4,3209
128,304,432,3,10,13,4,3210
206,420,626,7,20,27,4,3211
104,136,240,1,2,3,4,3212
7,24,31,0,1,1,4,3213
43,118,161,2,2,4,4,3214
70,12,82,3,1,4,4,3215
2,0,2,0,0,0,4,3216
5,16,21,0,0,0,4,3217
0,0,0,0,0,0,4,3218
0,2,2,0,0,0,4,3219
0,0,0,0,0,0,4,3220
7,28,35,0,0,0,4,3221
1,1,2,0,0,0,4,3222
9,20,29,0,0,0,4,3223
1,1,2,0,0,0,4,3224
3,2,5,0,0,0,4,3225
8,14,22,0,0,0,4,3226
1,0,1,0,0,0,4,3227
0,0,0,0,0,0,4,3228
0,1,1,0,0,0,4,3229
0,1,1,0,0,0,4,3230
0,5,5,0,0,0,4,3231
167,480,647,1,8,9,4,3232
2,4,6,0,0,0,4,3233
2,2,4,0,0,0,4,3234
0,0,0,0,0,0,4,3235
3,13,16,0,0,0,4,3236
1,0,1,0,0,0,4,3237
1,2,3,0,0,0,4,3238
0,9,9,0,0,0,4,3239
15,30,45,0,0,0,4,3240
2,7,9,0,0,0,4,3241
13,16,29,0,0,0,4,3242
5,7,12,0,0,0,4,3243
0,0,0,0,0,0,4,3244
2,3,5,0,0,0,4,3245
0,0,0,0,0,0,4,3246
10,1,11,0,0,0,4,3247
3,3,6,0,0,0,4,3248
2,3,5,0,0,0,4,3249
4,0,4,0,0,0,4,3250
1,5,6,0,0,0,4,3251
1,1,2,0,0,0,4,3252
3,0,3,0,0,0,4,3253
0,0,0,0,0,0,4,3254
1,0,1,0,0,0,4,3255
11,6,17,0,0,0,4,3256
14,18,32,0,0,0,4,3257
1,0,1,0,0,0,4,3258
0,0,0,0,0,0,4,3259
0,0,0,0,0,0,4,3260
0,0,0,0,0,0,4,3261
0,0,0,0,0,0,4,3262
0,0,0,0,0,0,4,3263
0,0,0,0,0,0,4,3264
1,0,1,0,0,0,4,3265
7,19,26,0,0,0,4,3266
15,12,27,0,0,0,4,3267
1,7,8,0,0,0,4,3268
120,801,921,8,23,31,4,3269
123,514,637,4,8,12,4,3270
0,0,0,0,0,0,4,3271
13,49,62,0,0,0,4,3272
28,91,119,0,2,2,4,3273
0,5,5,0,0,0,4,3274
166,238,404,2,3,5,4,3275
8,6,14,0,0,0,4,3276
8,77,85,0,1,1,4,3277
3,10,13,0,0,0,4,3278
1,0,1,1,0,1,4,3279
1,2,3,0,0,0,4,3280
2,0,2,0,0,0,4,3281
1,0,1,0,0,0,4,3282
1,0,1,0,0,0,4,3283
0,0,0,0,0,0,4,3284
2,3,5,0,0,0,4,3285
68,151,219,1,3,4,4,3286
0,0,0,0,0,0,4,3287
0,0,0,0,0,0,4,3288
0,0,0,0,0,0,4,3289
0,0,0,0,0,0,4,3290
0,0,0,0,0,0,4,3291
0,0,0,0,0,0,4,3292
0,0,0,0,0,0,4,3293
0,0,0,0,0,0,4,3294
0,0,0,0,0,0,4,3295
0,0,0,0,0,0,4,3296
0,0,0,0,0,0,4,3297
0,0,0,0,0,0,4,3298
0,1,1,0,0,0,4,3299
1,5,6,0,0,0,4,3300
2,3,5,0,0,0,4,3301
3,5,8,0,0,0,4,3302
5,8,13,0,1,1,4,3303
0,0,0,0,0,0,4,3304
0,0,0,0,0,0,4,3305
0,0,0,0,0,0,4,3306
0,0,0,0,0,0,4,3307
0,0,0,0,0,0,4,3308
0,0,0,0,0,0,4,3309
0,0,0,0,0,0,4,3310
0,0,0,0,0,0,4,3311
3,0,3,1,0,1,4,3312
29,134,163,1,1,2,4,3313
700,1069,1769,18,19,37,4,3314
28,159,187,0,4,4,4,3315
2,4,6,0,0,0,4,3316
6,7,13,1,0,1,4,3317
94,678,772,1,5,6,4,3318
0,8,8,0,0,0,4,3319
0,0,0,0,0,0,4,3320
0,2,2,0,0,0,4,3321
0,3,3,0,0,0,4,3322
3,14,17,0,0,0,4,3323
26,142,168,0,0,0,4,3324
0,12,12,0,0,0,4,3325
54,136,190,0,0,0,4,3326
89,395,484,1,5,6,4,3327
2994,16744,19738,27,67,94,4,3328
2679,11588,14267,43,95,138,4,3329
253,824,1077,5,14,19,4,3330
74,320,394,0,4,4,4,3331
20,50,70,0,0,0,4,3332
0,0,0,0,0,0,4,3333
3,10,13,0,0,0,4,3334
331,699,1030,5,9,14,4,3335
181,950,1131,5,9,14,4,3336
12,66,78,0,0,0,4,3337
234,733,967,1,4,5,4,3338
5476,14223,19699,54,93,147,4,3339
184,524,708,1,8,9,4,3340
146,462,608,1,6,7,4,3341
876,3375,4251,9,22,31,4,3342
1875,6042,7917,14,21,35,4,3343
3206,18789,21995,45,193,238,4,3344
27,262,289,1,1,2,4,3345
82,187,269,0,0,0,4,3346
0,0,0,0,0,0,4,3347
195,453,648,2,5,7,4,3348
88,166,254,0,3,3,4,3349
63,70,133,2,2,4,4,3350
44,230,274,3,8,11,4,3351
0,0,0,0,0,0,4,3352
5,0,5,0,0,0,4,3353
1,1,2,0,0,0,4,3354
2,0,2,0,0,0,4,3355
0,0,0,0,0,0,4,3356
5,1,6,0,0,0,4,3357
1,0,1,0,0,0,4,3358
1,1,2,0,0,0,4,3359
1,1,2,0,0,0,4,3360
0,0,0,0,0,0,4,3361
30,66,96,1,0,1,4,3362
10,12,22,0,1,1,4,3363
0,0,0,0,0,0,4,3364
436,237,673,1,4,5,4,3365
1,1,2,0,0,0,4,3366
3,2,5,0,0,0,4,3367
9,22,31,0,1,1,4,3368
0,0,0,0,0,0,4,3369
0,0,0,0,0,0,4,3370
0,0,0,0,0,0,4,3371
0,0,0,0,0,0,4,3372
2,1,3,0,0,0,4,3373
0,0,0,0,0,0,4,3374
1,3,4,0,0,0,4,3375
0,0,0,0,0,0,4,3376
0,0,0,0,0,0,4,3377
0,0,0,0,0,0,4,3378
0,0,0,0,0,0,4,3379
0,1,1,0,0,0,4,3380
0,0,0,0,0,0,4,3381
4,0,4,0,0,0,4,3382
0,0,0,0,0,0,4,3383
0,0,0,0,0,0,4,3384
8,34,42,0,0,0,4,3385
0,2,2,0,0,0,4,3386
1,18,19,0,0,0,4,3387
0,0,0,0,0,0,4,3388
1,19,20,0,1,1,4,3389
6,2,8,0,0,0,4,3390
5,2,7,0,0,0,4,3391
11,4,15,0,0,0,4,3392
20,4,24,0,0,0,4,3393
17,22,39,2,0,2,4,3394
6,3,9,0,0,0,4,3395
64,34,98,2,1,3,4,3396
0,0,0,0,0,0,4,3397
38,42,80,0,1,1,4,3398
0,1,1,0,0,0,4,3399
0,2,2,0,0,0,4,3400
5,2,7,0,0,0,4,3401
3,1,4,0,0,0,4,3402
2,0,2,0,0,0,4,3403
0,0,0,0,0,0,4,3404
0,4,4,0,0,0,4,3405
3,0,3,0,0,0,4,3406
24,111,135,0,2,2,4,3407
17,56,73,0,0,0,4,3408
30,87,117,0,2,2,4,3409
2,2,4,0,0,0,4,3410
4,17,21,0,1,1,4,3411
14,82,96,1,1,2,4,3412
21,53,74,0,1,1,4,3413
3,10,13,0,0,0,4,3414
23,42,65,0,1,1,4,3415
4,11,15,0,1,1,4,3416
28,99,127,1,1,2,4,3417
504,1859,2363,3,18,21,4,3418
15,28,43,0,0,0,4,3419
0,6,6,0,0,0,4,3420
15,40,55,1,1,2,4,3421
181,377,558,14,10,24,4,3422
11,12,23,0,0,0,4,3423
3,4,7,0,0,0,4,3424
7,8,15,0,0,0,4,3425
8,11,19,0,0,0,4,3426
56,105,161,0,1,1,4,3427
95,177,272,3,4,7,4,3428
50,107,157,0,1,1,4,3429
171,170,341,1,4,5,4,3430
1148,776,1924,23,5,28,4,3431
12,23,35,0,0,0,4,3432
8,11,19,0,1,1,4,3433
2,4,6,0,1,1,4,3434
4,8,12,1,0,1,4,3435
22,48,70,1,0,1,4,3436
94,33,127,3,1,4,4,3437
81,297,378,1,1,2,4,3438
0,0,0,0,0,0,4,3439
0,0,0,0,0,0,4,3440
0,0,0,0,0,0,4,3441
0,0,0,0,0,0,4,3442
3,2,5,0,0,0,4,3443
2926,931,3857,51,14,65,4,3444
123,176,299,1,2,3,4,3445
52,61,113,1,1,2,4,3446
46,163,209,0,3,3,4,3447
972,2682,3654,17,25,42,4,3448
442,1410,1852,4,13,17,4,3449
6,45,51,0,0,0,4,3450
8,71,79,0,0,0,4,3451
2,20,22,0,1,1,4,3452
17,81,98,0,0,0,4,3453
1,0,1,0,0,0,4,3454
14,0,14,0,0,0,4,3455
1,1,2,0,0,0,4,3456
4,14,18,0,0,0,4,3457
2,6,8,0,0,0,4,3458
8566,41491,50057,62,231,293,4,3459
2,0,2,0,0,0,4,3460
2,2,4,0,1,1,4,3461
36,19,55,0,0,0,4,3462
17,10,27,0,0,0,4,3463
14,20,34,1,1,2,4,3464
93,128,221,0,1,1,4,3465
3,71,74,0,1,1,4,3466
1,0,1,0,0,0,4,3467
592,773,1365,8,9,17,4,3468
76,126,202,3,1,4,4,3469
2,0,2,0,0,0,4,3470
16,12,28,0,0,0,4,3471
2,1,3,0,0,0,4,3472
0,2,2,0,0,0,4,3473
0,9,9,0,0,0,4,3474
2,9,11,0,0,0,4,3475
0,6,6,0,0,0,4,3476
0,1,1,0,0,0,4,3477
3,1,4,0,0,0,4,3478
49,82,131,1,1,2,4,3479
302,992,1294,13,18,31,4,3480
31,54,85,0,2,2,4,3481
17,15,32,1,0,1,4,3482
4,12,16,0,0,0,4,3483
5,17,22,0,1,1,4,3484
37,110,147,1,4,5,4,3485
3,11,14,0,0,0,4,3486
4,5,9,0,0,0,4,3487
6,33,39,1,1,2,4,3488
2,2,4,0,0,0,4,3489
1,0,1,0,0,0,4,3490
2,7,9,1,1,2,4,3491
39,32,71,1,1,2,4,3492
5,4,9,0,0,0,4,3493
17,25,42,1,0,1,4,3494
5,24,29,0,0,0,4,3495
1,9,10,0,1,1,4,3496
2,7,9,0,0,0,4,3497
15,69,84,0,0,0,4,3498
5,12,17,0,0,0,4,3499
10,35,45,1,0,1,4,3500
1,1,2,0,0,0,4,3501
4,10,14,0,0,0,4,3502
0,1,1,0,0,0,4,3503
0,0,0,0,0,0,4,3504
373,943,1316,4,19,23,4,3505
111,249,360,0,1,1,4,3506
47,116,163,2,2,4,4,3507
8,30,38,1,0,1,4,3508
0,0,0,0,0,0,4,3509
0,0,0,0,0,0,4,3510
0,0,0,0,0,0,4,3511
63,47,110,0,0,0,4,3512
856,1900,2756,15,20,35,4,3513
77,206,283,1,4,5,4,3514
106,333,439,6,6,12,4,3515
241,1040,1281,7,14,21,4,3516
6,4,10,0,0,0,4,3517
13,19,32,0,0,0,4,3518
0,0,0,0,0,0,4,3519
141,332,473,1,39,40,4,3520
0,0,0,0,0,0,4,3521
0,0,0,0,0,0,4,3522
1,0,1,0,0,0,4,3523
1,0,1,0,0,0,4,3524
2,1,3,0,0,0,4,3525
3,13,16,0,2,2,4,3526
2,2,4,0,0,0,4,3527
0,0,0,0,0,0,4,3528
1,0,1,0,0,0,4,3529
0,3,3,0,0,0,4,3530
0,0,0,0,0,0,4,3531
0,0,0,0,0,0,4,3532
0,0,0,0,0,0,4,3533
7,6,13,0,0,0,4,3534
0,2,2,0,0,0,4,3535
1,5,6,0,0,0,4,3536
1,2,3,0,0,0,4,3537
6,11,17,0,0,0,4,3538
14,43,57,0,0,0,4,3539
91,135,226,1,2,3,4,3540
1,4,5,0,0,0,4,3541
5,8,13,0,0,0,4,3542
13,29,42,0,0,0,4,3543
1,0,1,0,0,0,4,3544
0,0,0,0,0,0,4,3545
1009,1829,2838,33,43,76,4,3546
40,171,211,1,2,3,4,3547
15,104,119,0,0,0,4,3548
1,0,1,0,0,0,4,3549
5,0,5,0,0,0,4,3550
19,24,43,1,0,1,4,3551
6,0,6,0,0,0,4,3552
2,1,3,0,0,0,4,3553
1,3,4,0,0,0,4,3554
0,2,2,0,0,0,4,3555
111,113,224,1,0,1,4,3556
1,3,4,0,0,0,4,3557
12,35,47,0,1,1,4,3558
2,9,11,0,0,0,4,3559
5,0,5,0,0,0,4,3560
5,2,7,0,1,1,4,3561
9,28,37,0,0,0,4,3562
9,62,71,0,2,2,4,3563
0,0,0,0,0,0,4,3564
29,71,100,2,0,2,4,3565
2,1,3,0,0,0,4,3566
7,47,54,0,0,0,4,3567
94,436,530,5,16,21,4,3568
11,25,36,0,1,1,4,3569
1,2,3,0,0,0,4,3570
1,3,4,0,0,0,4,3571
2,1,3,0,0,0,4,3572
7,5,12,1,0,1,4,3573
10,10,20,1,0,1,4,3574
0,0,0,0,0,0,4,3575
0,1,1,0,0,0,4,3576
4,2,6,0,0,0,4,3577
7,30,37,0,0,0,4,3578
220,681,901,2,2,4,4,3579
41,106,147,0,0,0,4,3580
189,278,467,3,1,4,4,3581
4722,16483,21205,20,25,45,4,3582
1457,5231,6688,17,36,53,4,3583
53,210,263,0,7,7,4,3584
36,103,139,0,0,0,4,3585
2309,7468,9777,21,55,76,4,3586
2104,7423,9527,11,18,29,4,3587
1675,7334,9009,5,31,36,4,3588
5,3,8,1,0,1,4,3589
3,0,3,0,0,0,4,3590
1,1,2,0,0,0,4,3591
0,0,0,0,0,0,4,3592
5,34,39,0,1,1,4,3593
2,1,3,0,0,0,4,3594
0,2,2,0,0,0,4,3595
1,0,1,0,0,0,4,3596
3,2,5,0,0,0,4,3597
1,1,2,0,0,0,4,3598
0,0,0,0,0,0,4,3599
1,2,3,0,0,0,4,3600
26,37,63,0,0,0,4,3601
0,0,0,0,0,0,4,3602
40,111,151,0,3,3,4,3603
33,72,105,0,6,6,4,3604
1831,15879,17710,6,16,22,4,3605
16504,47409,63913,94,195,289,4,3606
59,192,251,0,0,0,4,3607
98,400,498,0,3,3,4,3608
23,140,163,0,2,2,4,3609
255,1097,1352,1,4,5,4,3610
871,2363,3234,37,88,125,4,3611
363,973,1336,1,5,6,4,3612
20,61,81,0,0,0,4,3613
33,112,145,0,1,1,4,3614
1020,3909,4929,17,59,76,4,3615
6,1,7,0,0,0,4,3616
3,3,6,0,0,0,4,3617
267,108,375,0,0,0,4,3618
57,35,92,1,0,1,4,3619
2,16,18,0,1,1,4,3620
0,18,18,0,0,0,4,3621
3,8,11,0,0,0,4,3622
2,9,11,0,0,0,4,3623
441,719,1160,7,6,13,4,3624
404,1126,1530,5,15,20,4,3625
0,10,10,0,0,0,4,3626
77,28,105,2,0,2,4,3627
43,52,95,2,2,4,4,3628
214,61,275,1,1,2,4,3629
0,0,0,0,0,0,4,3630
67,16,83,2,0,2,4,3631
15,1,16,2,1,3,4,3632
2,1,3,0,0,0,4,3633
5,8,13,0,1,1,4,3634
7,21,28,0,0,0,4,3635
0,3,3,0,0,0,4,3636
1,0,1,0,0,0,4,3637
0,0,0,0,0,0,4,3638
0,2,2,0,0,0,4,3639
1,3,4,0,0,0,4,3640
0,2,2,0,0,0,4,3641
0,2,2,0,0,0,4,3642
5,4,9,0,0,0,4,3643
0,0,0,0,0,0,4,3644
4,1,5,0,0,0,4,3645
1,0,1,0,0,0,4,3646
1,1,2,0,0,0,4,3647
2,6,8,0,0,0,4,3648
0,0,0,0,0,0,4,3649
1,6,7,0,0,0,4,3650
1,1,2,0,0,0,4,3651
2,6,8,0,0,0,4,3652
7,21,28,0,0,0,4,3653
4,1,5,1,0,1,4,3654
0,0,0,0,0,0,4,3655
0,2,2,0,0,0,4,3656
2,5,7,0,0,0,4,3657
0,0,0,0,0,0,4,3658
9,13,22,0,0,0,4,3659
22,53,75,0,0,0,4,3660
28,69,97,0,0,0,4,3661
23,32,55,0,0,0,4,3662
56,122,178,1,1,2,4,3663
1,8,9,0,0,0,4,3664
2,27,29,0,0,0,4,3665
8,27,35,0,0,0,4,3666
0,0,0,0,0,0,4,3667
0,0,0,0,0,0,4,3668
1,1,2,0,0,0,4,3669
64,138,202,0,0,0,4,3670
473,2053,2526,5,12,17,4,3671
28,22,50,1,0,1,4,3672
9,9,18,0,0,0,4,3673
4,0,4,0,0,0,4,3674
44,179,223,1,3,4,4,3675
11,13,24,1,0,1,4,3676
13,61,74,0,1,1,4,3677
10,29,39,0,0,0,4,3678
3,4,7,0,0,0,4,3679
0,0,0,0,0,0,4,3680
3,17,20,0,0,0,4,3681
0,1,1,0,0,0,4,3682
0,0,0,0,0,0,4,3683
1,1,2,0,0,0,4,3684
0,0,0,0,0,0,4,3685
0,0,0,0,0,0,4,3686
497,1622,2119,4,5,9,4,3687
905,2885,3790,7,9,16,4,3688
117,210,327,5,1,6,4,3689
163,365,528,0,1,1,4,3690
199,224,423,7,3,10,4,3691
468,2542,3010,7,15,22,4,3692
6,13,19,0,0,0,4,3693
2,12,14,0,0,0,4,3694
1,1,2,0,0,0,4,3695
1,0,1,0,0,0,4,3696
0,0,0,0,0,0,4,3697
1,0,1,0,0,0,4,3698
0,0,0,0,0,0,4,3699
0,0,0,0,0,0,4,3700
4,7,11,0,0,0,4,3701
2,3,5,0,0,0,4,3702
16,11,27,0,0,0,4,3703
96,192,288,4,8,12,4,3704
4,2,6,0,0,0,4,3705
4,6,10,0,0,0,4,3706
28,17,45,1,0,1,4,3707
138,242,380,7,18,25,4,3708
0,1,1,0,0,0,4,3709
412,1554,1966,6,16,22,4,3710
11,10,21,0,0,0,4,3711
8,3,11,0,0,0,4,3712
149,416,565,1,9,10,4,3713
5,27,32,0,0,0,4,3714
0,0,0,0,0,0,4,3715
17,11,28,0,0,0,4,3716
8,3,11,0,0,0,4,3717
0,0,0,0,0,0,4,3718
414,1446,1860,6,27,33,4,3719
31,122,153,0,0,0,4,3720
39,177,216,3,3,6,4,3721
7,36,43,0,0,0,4,3722
23,86,109,1,1,2,4,3723
0,1,1,0,0,0,4,3724
1,0,1,0,0,0,4,3725
0,0,0,0,0,0,4,3726
49,26,75,0,0,0,4,3727
35,55,90,0,0,0,4,3728
139,1370,1509,1,5,6,4,3729
7,13,20,0,0,0,4,3730
4,1,5,0,0,0,4,3731
18,19,37,1,0,1,4,3732
13,15,28,0,0,0,4,3733
2,19,21,0,0,0,4,3734
0,3,3,0,0,0,4,3735
0,1,1,0,0,0,4,3736
4,7,11,1,0,1,4,3737
0,1,1,0,0,0,4,3738
1,0,1,0,0,0,4,3739
0,0,0,0,0,0,4,3740
2,12,14,0,0,0,4,3741
0,0,0,0,0,0,4,3742
1,0,1,0,0,0,4,3743
1,0,1,0,0,0,4,3744
192,476,668,3,10,13,4,3745
225,705,930,2,8,10,4,3746
6,6,12,0,0,0,4,3747
522,1757,2279,11,22,33,4,3748
1,0,1,0,0,0,4,3749
1,5,6,0,0,0,4,3750
3,11,14,0,0,0,4,3751
19,7,26,2,1,3,4,3752
0,11,11,0,0,0,4,3753
1,2,3,0,0,0,4,3754
0,3,3,0,0,0,4,3755
0,0,0,0,0,0,4,3756
0,0,0,0,0,0,4,3757
0,0,0,0,0,0,4,3758
0,1,1,0,0,0,4,3759
0,0,0,0,0,0,4,3760
7,14,21,0,0,0,4,3761
0,0,0,0,0,0,4,3762
0,4,4,0,0,0,4,3763
17,45,62,1,0,1,4,3764
9,3,12,0,1,1,4,3765
1,0,1,0,0,0,4,3766
0,2,2,0,0,0,4,3767
0,0,0,0,0,0,4,3768
5,16,21,0,0,0,4,3769
0,0,0,0,0,0,4,3770
0,1,1,0,0,0,4,3771
0,0,0,0,0,0,4,3772
0,0,0,0,0,0,4,3773
52,56,108,4,3,7,4,3774
28,15,43,1,0,1,4,3775
1,0,1,0,0,0,4,3776
0,0,0,0,0,0,4,3777
0,0,0,0,0,0,4,3778
0,0,0,0,0,0,4,3779
28,19,47,3,0,3,4,3780
0,0,0,0,0,0,4,3781
2,0,2,0,0,0,4,3782
6,4,10,0,0,0,4,3783
483,168,651,6,2,8,4,3784
0,0,0,0,0,0,4,3785
0,1,1,0,0,0,4,3786
75,26,101,1,1,2,4,3787
17,9,26,1,0,1,4,3788
5,3,8,0,0,0,4,3789
2,1,3,1,0,1,4,3790
0,0,0,0,0,0,4,3791
0,0,0,0,0,0,4,3792
0,0,0,0,0,0,4,3793
7,2,9,0,0,0,4,3794
0,0,0,0,0,0,4,3795
1,0,1,0,0,0,4,3796
1,0,1,0,0,0,4,3797
0,0,0,0,0,0,4,3798
1,3,4,0,0,0,4,3799
2,0,2,0,0,0,4,3800
1,0,1,0,0,0,4,3801
0,0,0,0,0,0,4,3802
0,0,0,0,0,0,4,3803
1,0,1,0,0,0,4,3804
1,0,1,0,0,0,4,3805
1,0,1,0,0,0,4,3806
3,27,30,0,1,1,4,3807
0,0,0,0,0,0,4,3808
1,5,6,0,0,0,4,3809
0,3,3,0,1,1,4,3810
3,2,5,0,0,0,4,3811
0,0,0,0,0,0,4,3812
0,1,1,0,0,0,4,3813
0,1,1,0,0,0,4,3814
1,10,11,0,0,0,4,3815
0,0,0,0,0,0,4,3816
0,0,0,0,0,0,4,3817
0,0,0,0,0,0,4,3818
0,0,0,0,0,0,4,3819
0,0,0,0,0,0,4,3820
0,0,0,0,0,0,4,3821
0,0,0,0,0,0,4,3822
0,0,0,0,0,0,4,3823
0,0,0,0,0,0,4,3824
0,3,3,0,0,0,4,3825
0,1,1,0,0,0,4,3826
0,3,3,0,0,0,4,3827
32,143,175,1,4,5,4,3828
43,70,113,1,0,1,4,3829
7,12,19,0,1,1,4,3830
9,10,19,0,1,1,4,3831
10,28,38,0,0,0,4,3832
0,4,4,0,0,0,4,3833
10,11,21,0,1,1,4,3834
0,0,0,0,0,0,4,3835
137,356,493,4,11,15,4,3836
3,8,11,0,0,0,4,3837
4,5,9,0,0,0,4,3838
0,0,0,0,0,0,4,3839
0,5,5,0,0,0,4,3840
2,1,3,0,0,0,4,3841
831,4004,4835,10,48,58,4,3842
42,90,132,0,1,1,4,3843
2,1,3,0,0,0,4,3844
0,0,0,0,0,0,4,3845
0,0,0,0,0,0,4,3846
1,0,1,0,0,0,4,3847
2,5,7,0,0,0,4,3848
0,0,0,0,0,0,4,3849
0,0,0,0,0,0,4,3850
1,1,2,0,0,0,4,3851
0,0,0,0,0,0,4,3852
1,0,1,0,0,0,4,3853
0,0,0,0,0,0,4,3854
6,13,19,2,0,2,4,3855
2,0,2,0,0,0,4,3856
0,1,1,0,0,0,4,3857
2,0,2,0,0,0,4,3858
0,0,0,0,0,0,4,3859
15,9,24,1,0,1,4,3860
0,4,4,0,0,0,4,3861
2,4,6,0,0,0,4,3862
5,6,11,0,0,0,4,3863
11,2,13,0,0,0,4,3864
1,1,2,0,0,0,4,3865
83,38,121,2,1,3,4,3866
44,121,165,0,1,1,4,3867
2,5,7,0,0,0,4,3868
0,2,2,0,0,0,4,3869
4,2,6,1,0,1,4,3870
0,0,0,0,0,0,4,3871
1,1,2,0,0,0,4,3872
0,7,7,0,0,0,4,3873
7,2,9,0,0,0,4,3874
8,9,17,0,0,0,4,3875
2,3,5,0,0,0,4,3876
2,1,3,0,0,0,4,3877
0,1,1,0,0,0,4,3878
0,0,0,0,0,0,4,3879
3,5,8,0,0,0,4,3880
1,6,7,0,0,0,4,3881
1,1,2,0,0,0,4,3882
0,1,1,0,0,0,4,3883
3,1,4,0,0,0,4,3884
0,0,0,0,0,0,4,3885
0,4,4,0,0,0,4,3886
1,1,2,0,0,0,4,3887
44,22,66,5,2,7,4,3888
2,1,3,0,0,0,4,3889
10,8,18,0,0,0,4,3890
3,9,12,0,0,0,4,3891
0,0,0,0,0,0,4,3892
1,1,2,0,0,0,4,3893
1,2,3,0,0,0,4,3894
0,0,0,0,0,0,4,3895
3,20,23,0,0,0,4,3896
0,0,0,0,0,0,4,3897
3,7,10,0,0,0,4,3898
2,3,5,1,0,1,4,3899
2,1,3,0,0,0,4,3900
6,1,7,0,0,0,4,3901
7,1,8,0,0,0,4,3902
13,43,56,0,1,1,4,3903
2,13,15,0,0,0,4,3904
0,0,0,0,0,0,4,3905
0,2,2,0,0,0,4,3906
0,0,0,0,0,0,4,3907
0,0,0,0,0,0,4,3908
0,0,0,0,0,0,4,3909
4,5,9,0,1,1,4,3910
0,2,2,0,0,0,4,3911
10,5,15,1,0,1,4,3912
5,2,7,0,1,1,4,3913
3,2,5,1,0,1,4,3914
3,3,6,0,0,0,4,3915
2,0,2,0,0,0,4,3916
1,0,1,0,0,0,4,3917
0,0,0,0,0,0,4,3918
0,0,0,0,0,0,4,3919
0,0,0,0,0,0,4,3920
0,0,0,0,0,0,4,3921
12,18,30,0,0,0,4,3922
0,0,0,0,0,0,4,3923
2,0,2,0,0,0,4,3924
0,0,0,0,0,0,4,3925
0,0,0,0,0,0,4,3926
17,11,28,1,0,1,4,3927
10,12,22,0,0,0,4,3928
1,3,4,0,0,0,4,3929
0,0,0,0,0,0,4,3930
0,0,0,0,0,0,4,3931
1,1,2,0,0,0,4,3932
126,356,482,2,6,8,4,3933
3,4,7,1,0,1,4,3934
0,0,0,0,0,0,4,3935
1,2,3,0,0,0,4,3936
1,1,2,0,0,0,4,3937
0,0,0,0,0,0,4,3938
0,0,0,0,0,0,4,3939
0,0,0,0,0,0,4,3940
1,0,1,0,0,0,4,3941
12,29,41,0,0,0,4,3942
0,0,0,0,0,0,4,3943
1,0,1,0,0,0,4,3944
4,0,4,0,0,0,4,3945
10,5,15,1,0,1,4,3946
0,0,0,0,0,0,4,3947
1,0,1,0,0,0,4,3948
1,1,2,0,0,0,4,3949
4,0,4,0,0,0,4,3950
74,214,288,3,9,12,4,3951
0,0,0,0,0,0,4,3952
0,0,0,0,0,0,4,3953
1,0,1,0,0,0,4,3954
2,2,4,0,0,0,4,3955
4,7,11,0,0,0,4,3956
0,0,0,0,0,0,4,3957
0,0,0,0,0,0,4,3958
8,32,40,0,0,0,4,3959
5,5,10,0,0,0,4,3960
1,0,1,0,0,0,4,3961
6,3,9,0,0,0,4,3962
0,0,0,0,0,0,4,3963
0,0,0,0,0,0,4,3964
6,4,10,0,0,0,4,3965
0,0,0,0,0,0,4,3966
0,0,0,0,0,0,4,3967
1,2,3,0,0,0,4,3968
8,1,9,0,0,0,4,3969
13,7,20,0,0,0,4,3970
11,3,14,1,0,1,4,3971
1,0,1,0,0,0,4,3972
0,0,0,0,0,0,4,3973
1,0,1,0,0,0,4,3974
2,0,2,0,0,0,4,3975
2,1,3,0,0,0,4,3976
2,2,4,0,0,0,4,3977
11,3,14,2,0,2,4,3978
0,0,0,0,0,0,4,3979
0,0,0,0,0,0,4,3980
0,0,0,0,0,0,4,3981
1,3,4,0,0,0,4,3982
0,0,0,0,0,0,4,3983
0,1,1,0,0,0,4,3984
1,2,3,0,0,0,4,3985
0,0,0,0,0,0,4,3986
0,0,0,0,0,0,4,3987
0,0,0,0,0,0,4,3988
7,68,75,0,3,3,4,3989
4,1,5,0,0,0,4,3990
0,0,0,0,0,0,4,3991
3,1,4,0,0,0,4,3992
0,0,0,0,0,0,4,3993
0,0,0,0,0,0,4,3994
6,0,6,0,0,0,4,3995
12,68,80,0,0,0,4,3996
2,23,25,0,0,0,4,3997
0,2,2,0,0,0,4,3998
0,0,0,0,0,0,4,3999
3,0,3,0,0,0,4,4000
2,1,3,0,0,0,4,4001
2,7,9,0,0,0,4,4002
0,1,1,0,0,0,4,4003
1,0,1,0,0,0,4,4004
0,0,0,0,0,0,4,4005
0,1,1,0,0,0,4,4006
102,292,394,3,4,7,4,4007
1,0,1,0,0,0,4,4008
1,4,5,0,0,0,4,4009
1,2,3,0,0,0,4,4010
0,0,0,0,0,0,4,4011
1,1,2,0,1,1,4,4012
2,2,4,0,0,0,4,4013
0,1,1,0,0,0,4,4014
0,0,0,0,0,0,4,4015
1,0,1,0,0,0,4,4016
2,1,3,1,0,1,4,4017
29,41,70,1,0,1,4,4018
18,47,65,0,0,0,4,4019
5,11,16,0,0,0,4,4020
3,1,4,0,0,0,4,4021
1,4,5,0,0,0,4,4022
8,29,37,0,0,0,4,4023
0,0,0,0,0,0,4,4024
1,1,2,0,0,0,4,4025
0,0,0,0,0,0,4,4026
1,13,14,0,1,1,4,4027
3,0,3,0,0,0,4,4028
1,1,2,0,0,0,4,4029
0,0,0,0,0,0,4,4030
0,2,2,0,0,0,4,4031
1,0,1,0,0,0,4,4032
0,0,0,0,0,0,4,4033
8,2,10,0,0,0,4,4034
33,157,190,5,6,11,4,4035
0,0,0,0,0,0,4,4036
0,1,1,0,0,0,4,4037
0,0,0,0,0,0,4,4038
0,0,0,0,0,0,4,4039
0,0,0,0,0,0,4,4040
0,0,0,0,0,0,4,4041
0,6,6,0,0,0,4,4042
1,1,2,0,0,0,4,4043
5,14,19,0,0,0,4,4044
0,0,0,0,0,0,4,4045
4,8,12,0,1,1,4,4046
8,12,20,0,0,0,4,4047
0,0,0,0,0,0,4,4048
4,0,4,0,0,0,4,4049
1,2,3,0,0,0,4,4050
30,6,36,0,0,0,4,4051
0,0,0,0,0,0,4,4052
1,0,1,0,0,0,4,4053
1,0,1,0,0,0,4,4054
0,0,0,0,0,0,4,4055
0,1,1,0,0,0,4,4056
0,0,0,0,0,0,4,4057
0,0,0,0,0,0,4,4058
1,1,2,0,0,0,4,4059
74,70,144,4,1,5,4,4060
5605,6206,11811,44,31,75,4,4061
659,1892,2551,2,13,15,4,4062
0,0,0,0,0,0,4,4063
0,0,0,0,0,0,4,4064
0,1,1,0,0,0,4,4065
0,0,0,0,0,0,4,4066
6,3,9,0,0,0,4,4067
60,26,86,4,0,4,4,4068
0,0,0,0,0,0,4,4069
1,1,2,0,0,0,4,4070
0,1,1,0,0,0,4,4071
752,2350,3102,21,35,56,4,4072
1,1,2,0,0,0,4,4073
149,127,276,4,2,6,4,4074
77,49,126,2,3,5,4,4075
3,4,7,0,0,0,4,4076
412,308,720,6,7,13,4,4077
0,0,0,0,0,0,4,4078
0,0,0,0,0,0,4,4079
9,6,15,1,0,1,4,4080
3,2,5,0,0,0,4,4081
3,5,8,0,2,2,4,4082
2,6,8,0,0,0,4,4083
0,0,0,0,0,0,4,4084
10,4,14,0,0,0,4,4085
9,7,16,1,1,2,4,4086
49,137,186,2,1,3,4,4087
5,50,55,0,0,0,4,4088
0,0,0,0,0,0,4,4089
11,6,17,0,0,0,4,4090
10,1,11,0,0,0,4,4091
5,1,6,0,0,0,4,4092
0,0,0,0,0,0,4,4093
0,0,0,0,0,0,4,4094
6,22,28,0,0,0,4,4095
19,49,68,1,1,2,4,4096
0,0,0,0,0,0,4,4097
1,2,3,0,0,0,4,4098
4,2,6,0,0,0,4,4099
2,0,2,0,0,0,4,4100
0,0,0,0,0,0,4,4101
0,1,1,0,0,0,4,4102
0,0,0,0,0,0,4,4103
0,0,0,0,0,0,4,4104
0,0,0,0,0,0,4,4105
0,0,0,0,0,0,4,4106
0,0,0,0,0,0,4,4107
0,0,0,0,0,0,4,4108
0,1,1,0,0,0,4,4109
2,1,3,0,0,0,4,4110
0,2,2,0,0,0,4,4111
0,0,0,0,0,0,4,4112
0,0,0,0,0,0,4,4113
6,2,8,0,0,0,4,4114
0,0,0,0,0,0,4,4115
0,0,0,0,0,0,4,4116
8,12,20,0,0,0,4,4117
0,0,0,0,0,0,4,4118
1,1,2,0,0,0,4,4119
3,5,8,0,1,1,4,4120
0,0,0,0,0,0,4,4121
2,1,3,0,0,0,4,4122
0,1,1,0,0,0,4,4123
1,1,2,0,0,0,4,4124
0,0,0,0,0,0,4,4125
2,1,3,0,0,0,4,4126
0,0,0,0,0,0,4,4127
0,0,0,0,0,0,4,4128
1,0,1,0,0,0,4,4129
0,0,0,0,0,0,4,4130
0,0,0,0,0,0,4,4131
1,0,1,0,0,0,4,4132
0,0,0,0,0,0,4,4133
2,3,5,0,0,0,4,4134
1,0,1,0,0,0,4,4135
0,0,0,0,0,0,4,4136
1,1,2,0,0,0,4,4137
18,50,68,0,1,1,4,4138
0,0,0,0,0,0,4,4139
0,0,0,0,0,0,4,4140
1,0,1,0,0,0,4,4141
0,0,0,0,0,0,4,4142
0,0,0,0,0,0,4,4143
3,1,4,0,0,0,4,4144
34,76,110,2,5,7,4,4145
3,12,15,0,0,0,4,4146
0,1,1,0,0,0,4,4147
0,0,0,0,0,0,4,4148
0,0,0,0,0,0,4,4149
1,2,3,0,0,0,4,4150
0,0,0,0,0,0,4,4151
3,0,3,0,0,0,4,4152
10,10,20,0,0,0,4,4153
0,0,0,0,0,0,4,4154
0,0,0,0,0,0,4,4155
0,0,0,0,0,0,4,4156
0,0,0,0,0,0,4,4157
1,0,1,0,0,0,4,4158
5,11,16,0,1,1,4,4159
1,2,3,0,0,0,4,4160
67,315,382,0,5,5,4,4161
3,3,6,0,0,0,4,4162
0,0,0,0,0,0,4,4163
0,0,0,0,0,0,4,4164
1,0,1,0,0,0,4,4165
26,7,33,1,1,2,4,4166
0,0,0,0,0,0,4,4167
0,0,0,0,0,0,4,4168
0,0,0,0,0,0,4,4169
0,0,0,0,0,0,4,4170
1,1,2,0,0,0,4,4171
0,0,0,0,0,0,4,4172
0,0,0,0,0,0,4,4173
0,0,0,0,0,0,4,4174
0,1,1,0,0,0,4,4175
0,0,0,0,0,0,4,4176
1,0,1,1,0,1,4,4177
0,0,0,0,0,0,4,4178
0,0,0,0,0,0,4,4179
0,0,0,0,0,0,4,4180
0,0,0,0,0,0,4,4181
2,2,4,0,0,0,4,4182
6,2,8,0,0,0,4,4183
0,0,0,0,0,0,4,4184
0,1,1,0,0,0,4,4185
18,45,63,2,3,5,4,4186
0,1,1,0,0,0,4,4187
3,0,3,0,0,0,4,4188
1,0,1,0,0,0,4,4189
3,0,3,0,0,0,4,4190
0,0,0,0,0,0,4,4191
0,0,0,0,0,0,4,4192
0,1,1,0,0,0,4,4193
4,0,4,0,0,0,4,4194
5,2,7,0,1,1,4,4195
16,22,38,0,0,0,4,4196
0,0,0,0,0,0,4,4197
1,0,1,0,0,0,4,4198
161,484,645,3,3,6,4,4199
2,2,4,0,0,0,4,4200
0,0,0,0,0,0,4,4201
0,0,0,0,0,0,4,4202
0,0,0,0,0,0,4,4203
0,0,0,0,0,0,4,4204
0,1,1,0,0,0,4,4205
0,0,0,0,0,0,4,4206
2,0,2,0,0,0,4,4207
0,0,0,0,0,0,4,4208
0,1,1,0,0,0,4,4209
0,1,1,0,0,0,4,4210
0,0,0,0,0,0,4,4211
0,0,0,0,0,0,4,4212
0,2,2,0,0,0,4,4213
0,0,0,0,0,0,4,4214
1,0,1,0,0,0,4,4215
0,0,0,0,0,0,4,4216
7,5,12,0,0,0,4,4217
0,4,4,0,0,0,4,4218
4,13,17,0,0,0,4,4219
4,10,14,0,0,0,4,4220
3,3,6,0,1,1,4,4221
0,0,0,0,0,0,4,4222
13,137,150,0,0,0,4,4223
0,1,1,0,0,0,4,4224
4,5,9,0,0,0,4,4225
1,2,3,0,0,0,4,4226
0,4,4,0,0,0,4,4227
19,9,28,0,0,0,4,4228
0,0,0,0,0,0,4,4229
5,5,10,0,0,0,4,4230
25,33,58,1,2,3,4,4231
2,0,2,0,0,0,4,4232
0,0,0,0,0,0,4,4233
0,0,0,0,0,0,4,4234
91,401,492,1,17,18,4,4235
0,3,3,0,0,0,4,4236
0,0,0,0,0,0,4,4237
0,0,0,0,0,0,4,4238
0,0,0,0,0,0,4,4239
1,2,3,0,0,0,4,4240
3,0,3,0,0,0,4,4241
5,0,5,0,0,0,4,4242
4,1,5,0,0,0,4,4243
3,3,6,0,0,0,4,4244
13,33,46,2,1,3,4,4245
98,192,290,3,5,8,4,4246
1,2,3,0,0,0,4,4247
19,17,36,0,0,0,4,4248
1,0,1,0,0,0,4,4249
1,0,1,0,0,0,4,4250
1,0,1,0,0,0,4,4251
2,0,2,0,0,0,4,4252
0,0,0,0,0,0,4,4253
0,0,0,0,0,0,4,4254
0,0,0,0,0,0,4,4255
1,0,1,0,0,0,4,4256
18,4,22,0,0,0,4,4257
0,0,0,0,0,0,4,4258
0,0,0,0,0,0,4,4259
1,1,2,0,0,0,4,4260
5,0,5,0,0,0,4,4261
9,4,13,0,0,0,4,4262
18,10,28,2,3,5,4,4263
3,9,12,0,0,0,4,4264
123,662,785,5,14,19,4,4265
1,0,1,0,0,0,4,4266
0,0,0,0,0,0,4,4267
0,0,0,0,0,0,4,4268
8,2,10,0,0,0,4,4269
0,1,1,0,0,0,4,4270
2,1,3,0,0,0,4,4271
62,83,145,1,1,2,4,4272
5,22,27,0,0,0,4,4273
6,0,6,0,0,0,4,4274
0,1,1,0,0,0,4,4275
0,0,0,0,0,0,4,4276
1,2,3,0,1,1,4,4277
0,0,0,0,0,0,4,4278
6,21,27,2,1,3,4,4279
1,1,2,0,0,0,4,4280
0,2,2,0,0,0,4,4281
0,0,0,0,0,0,4,4282
0,0,0,0,0,0,4,4283
21,30,51,1,1,2,4,4284
1,1,2,0,0,0,4,4285
4,1,5,0,0,0,4,4286
0,0,0,0,0,0,4,4287
0,0,0,0,0,0,4,4288
0,0,0,0,0,0,4,4289
1,0,1,0,0,0,4,4290
7,13,20,0,0,0,4,4291
1,1,2,0,0,0,4,4292
56,26,82,0,0,0,4,4293
6,2,8,1,0,1,4,4294
13,57,70,0,1,1,4,4295
5,0,5,0,0,0,4,4296
4,3,7,0,0,0,4,4297
0,1,1,0,0,0,4,4298
314,51,365,1,0,1,4,4299
1,0,1,0,0,0,4,4300
3,26,29,0,0,0,4,4301
1,0,1,0,0,0,4,4302
1,6,7,0,0,0,4,4303
88,139,227,2,0,2,4,4304
7,32,39,0,0,0,4,4305
11,6,17,0,0,0,4,4306
0,0,0,0,0,0,4,4307
0,1,1,0,0,0,4,4308
6,6,12,0,0,0,4,4309
2,7,9,1,1,2,4,4310
1,3,4,0,0,0,4,4311
4,9,13,0,0,0,4,4312
1,1,2,0,0,0,4,4313
1,0,1,0,0,0,4,4314
243,170,413,10,3,13,4,4315
1,2,3,0,0,0,4,4316
14,14,28,0,0,0,4,4317
5,15,20,0,0,0,4,4318
0,0,0,0,0,0,4,4319
0,0,0,0,0,0,4,4320
8,1,9,1,0,1,4,4321
3,6,9,0,0,0,4,4322
10,2,12,0,0,0,4,4323
3,4,7,0,0,0,4,4324
14,11,25,1,0,1,4,4325
1,8,9,0,0,0,4,4326
9,9,18,0,0,0,4,4327
1,0,1,0,0,0,4,4328
24,93,117,0,3,3,4,4329
15,11,26,0,0,0,4,4330
6,13,19,0,0,0,4,4331
1,6,7,0,0,0,4,4332
5,21,26,0,0,0,4,4333
0,0,0,0,0,0,4,4334
0,0,0,0,0,0,4,4335
1,1,2,0,0,0,4,4336
6,0,6,0,0,0,4,4337
2,0,2,0,0,0,4,4338
2,0,2,1,0,1,4,4339
0,2,2,0,0,0,4,4340
21,17,38,0,1,1,4,4341
0,0,0,0,0,0,4,4342
4,0,4,0,0,0,4,4343
0,0,0,0,0,0,4,4344
2,0,2,0,0,0,4,4345
1,0,1,0,0,0,4,4346
0,0,0,0,0,0,4,4347
0,0,0,0,0,0,4,4348
0,0,0,0,0,0,4,4349
450,571,1021,1,0,1,4,4350
0,0,0,0,0,0,4,4351
3,2,5,0,0,0,4,4352
3,4,7,0,0,0,4,4353
1,0,1,0,0,0,4,4354
0,0,0,0,0,0,4,4355
3,7,10,0,1,1,4,4356
5,19,24,0,1,1,4,4357
0,3,3,0,0,0,4,4358
7,1,8,0,0,0,4,4359
9,22,31,0,2,2,4,4360
1,1,2,0,0,0,4,4361
1,1,2,0,0,0,4,4362
0,1,1,0,0,0,4,4363
0,1,1,0,0,0,4,4364
0,1,1,0,0,0,4,4365
0,0,0,0,0,0,4,4366
0,0,0,0,0,0,4,4367
0,0,0,0,0,0,4,4368
0,0,0,0,0,0,4,4369
0,0,0,0,0,0,4,4370
0,1,1,0,0,0,4,4371
0,0,0,0,0,0,4,4372
0,0,0,0,0,0,4,4373
1,0,1,0,0,0,4,4374
2,0,2,0,0,0,4,4375
0,1,1,0,0,0,4,4376
1,2,3,0,0,0,4,4377
3,0,3,0,0,0,4,4378
6,2,8,0,0,0,4,4379
4,2,6,0,1,1,4,4380
0,0,0,0,0,0,4,4381
0,6,6,0,0,0,4,4382
1,0,1,0,0,0,4,4383
5,13,18,0,0,0,4,4384
16,6,22,0,0,0,4,4385
12,5,17,0,0,0,4,4386
0,0,0,0,0,0,4,4387
0,0,0,0,0,0,4,4388
9,5,14,0,0,0,4,4389
2,7,9,0,0,0,4,4390
9,22,31,0,1,1,4,4391
7,38,45,0,0,0,4,4392
1,0,1,0,0,0,4,4393
2,2,4,0,0,0,4,4394
0,2,2,0,0,0,4,4395
0,0,0,0,0,0,4,4396
8,6,14,0,0,0,4,4397
1,0,1,0,0,0,4,4398
6,26,32,1,6,7,4,4399
13,23,36,0,0,0,4,4400
0,0,0,0,0,0,4,4401
2,2,4,0,0,0,4,4402
2,0,2,0,0,0,4,4403
17,5,22,0,0,0,4,4404
85,389,474,0,0,0,4,4405
99,307,406,5,9,14,4,4406
23,5,28,3,1,4,4,4407
18,20,38,1,0,1,4,4408
4,5,9,0,0,0,4,4409
5,0,5,0,0,0,4,4410
1,0,1,0,0,0,4,4411
0,0,0,0,0,0,4,4412
1,2,3,0,0,0,4,4413
0,0,0,0,0,0,4,4414
0,9,9,0,0,0,4,4415
1,1,2,0,0,0,4,4416
0,1,1,0,0,0,4,4417
1,0,1,0,0,0,4,4418
1,1,2,0,0,0,4,4419
0,0,0,0,0,0,4,4420
0,1,1,0,0,0,4,4421
13,37,50,0,1,1,4,4422
3,1,4,0,0,0,4,4423
1,1,2,0,0,0,4,4424
0,9,9,0,1,1,4,4425
7,4,11,0,0,0,4,4426
3,1,4,0,0,0,4,4427
0,0,0,0,0,0,4,4428
0,1,1,0,0,0,4,4429
0,1,1,0,0,0,4,4430
2,1,3,0,0,0,4,4431
14,0,14,0,0,0,4,4432
2,1,3,0,0,0,4,4433
7,1,8,0,0,0,4,4434
2,4,6,0,0,0,4,4435
3,3,6,0,0,0,4,4436
0,0,0,0,0,0,4,4437
5,4,9,0,0,0,4,4438
4,0,4,0,0,0,4,4439
2,4,6,0,0,0,4,4440
4,3,7,0,0,0,4,4441
15,24,39,1,0,1,4,4442
2,0,2,0,0,0,4,4443
1,0,1,0,0,0,4,4444
1,1,2,0,0,0,4,4445
2,0,2,0,0,0,4,4446
0,0,0,0,0,0,4,4447
1,1,2,0,0,0,4,4448
0,0,0,0,0,0,4,4449
0,2,2,0,0,0,4,4450
0,0,0,0,0,0,4,4451
3,0,3,0,0,0,4,4452
2958,2720,5678,178,132,310,4,4453
2319,1593,3912,109,66,175,4,4454
5,2,7,1,1,2,4,4455
5,1,6,0,0,0,4,4456
10,85,95,3,19,22,4,4457
0,2,2,0,0,0,4,4458
2,0,2,0,0,0,4,4459
9,1,10,0,0,0,4,4460
9,9,18,0,0,0,4,4461
6,3,9,0,1,1,4,4462
0,0,0,0,0,0,4,4463
1,0,1,0,0,0,4,4464
4,3,7,0,0,0,4,4465
4,0,4,0,0,0,4,4466
4,1,5,0,0,0,4,4467
3,0,3,0,0,0,4,4468
2,0,2,0,0,0,4,4469
0,0,0,0,0,0,4,4470
2,0,2,0,0,0,4,4471
2,0,2,0,0,0,4,4472
4,4,8,0,1,1,4,4473
0,0,0,0,0,0,4,4474
18335,12843,31178,158,99,257,4,4475
0,0,0,0,0,0,4,4476
0,2,2,0,0,0,4,4477
1,1,2,0,0,0,4,4478
38,14,52,2,1,3,4,4479
13,6,19,0,0,0,4,4480
16,14,30,0,0,0,4,4481
1,0,1,0,0,0,4,4482
0,0,0,0,0,0,4,4483
0,1,1,0,0,0,4,4484
5,3,8,0,2,2,4,4485
0,0,0,0,0,0,4,4486
2,1,3,0,0,0,4,4487
10,51,61,0,0,0,4,4488
2,0,2,0,0,0,4,4489
4,3,7,0,0,0,4,4490
2,1,3,0,0,0,4,4491
0,0,0,0,0,0,4,4492
21,13,34,1,0,1,4,4493
17,13,30,0,0,0,4,4494
2,2,4,0,0,0,4,4495
0,4,4,0,0,0,4,4496
1,1,2,0,0,0,4,4497
1,0,1,0,0,0,4,4498
2,0,2,0,0,0,4,4499
15,12,27,0,0,0,4,4500
0,0,0,0,0,0,4,4501
0,0,0,0,0,0,4,4502
11,14,25,0,2,2,4,4503
0,0,0,0,0,0,4,4504
1,0,1,0,0,0,4,4505
3,1,4,0,0,0,4,4506
20,4,24,0,0,0,4,4507
1,0,1,0,0,0,4,4508
1,1,2,0,0,0,4,4509
0,2,2,0,0,0,4,4510
0,1,1,0,0,0,4,4511
18,6,24,0,0,0,4,4512
5,6,11,1,0,1,4,4513
4,0,4,0,0,0,4,4514
1,0,1,0,0,0,4,4515
3,0,3,0,0,0,4,4516
1,2,3,0,0,0,4,4517
9,6,15,0,0,0,4,4518
3,2,5,0,0,0,4,4519
0,2,2,0,0,0,4,4520
0,0,0,0,0,0,4,4521
1,0,1,0,0,0,4,4522
0,3,3,0,0,0,4,4523
0,2,2,0,0,0,4,4524
2,0,2,0,0,0,4,4525
5,3,8,0,0,0,4,4526
1,0,1,0,0,0,4,4527
0,0,0,0,0,0,4,4528
0,0,0,0,0,0,4,4529
2,5,7,0,0,0,4,4530
1,1,2,0,0,0,4,4531
0,0,0,0,0,0,4,4532
2,1,3,0,0,0,4,4533
0,0,0,0,0,0,4,4534
1,1,2,0,0,0,4,4535
0,2,2,0,0,0,4,4536
2,0,2,0,0,0,4,4537
1,0,1,0,0,0,4,4538
1,3,4,0,0,0,4,4539
0,3,3,0,0,0,4,4540
0,0,0,0,0,0,4,4541
6,1,7,0,1,1,4,4542
7,2,9,0,1,1,4,4543
0,0,0,0,0,0,4,4544
0,1,1,0,1,1,4,4545
225,123,348,4,0,4,4,4546
1,0,1,0,0,0,4,4547
45,79,124,5,3,8,4,4548
1,8,9,0,0,0,4,4549
6,34,40,1,0,1,4,4550
0,0,0,0,0,0,4,4551
0,0,0,0,0,0,4,4552
0,2,2,0,0,0,4,4553
26,43,69,1,0,1,4,4554
27,31,58,1,0,1,4,4555
2,0,2,0,0,0,4,4556
0,0,0,0,0,0,4,4557
0,0,0,0,0,0,4,4558
0,4,4,0,0,0,4,4559
0,0,0,0,0,0,4,4560
0,2,2,0,0,0,4,4561
0,0,0,0,0,0,4,4562
1,0,1,0,0,0,4,4563
0,2,2,0,0,0,4,4564
0,0,0,0,0,0,4,4565
1,6,7,1,0,1,4,4566
1,1,2,0,0,0,4,4567
0,1,1,0,0,0,4,4568
0,5,5,0,0,0,4,4569
1,1,2,0,1,1,4,4570
2,3,5,0,1,1,4,4571
3,0,3,0,0,0,4,4572
0,1,1,0,0,0,4,4573
0,0,0,0,0,0,4,4574
0,0,0,0,0,0,4,4575
6,1,7,0,0,0,4,4576
1,0,1,0,0,0,4,4577
4,2,6,0,0,0,4,4578
1,3,4,0,0,0,4,4579
0,0,0,0,0,0,4,4580
1,0,1,0,0,0,4,4581
1,0,1,0,0,0,4,4582
0,0,0,0,0,0,4,4583
0,0,0,0,0,0,4,4584
0,0,0,0,0,0,4,4585
0,0,0,0,0,0,4,4586
0,0,0,0,0,0,4,4587
1,0,1,0,0,0,4,4588
0,3,3,0,0,0,4,4589
7,2,9,0,0,0,4,4590
0,0,0,0,0,0,4,4591
1,3,4,0,0,0,4,4592
0,1,1,0,0,0,4,4593
1,5,6,0,1,1,4,4594
7,9,16,0,0,0,4,4595
749,384,1133,33,18,51,4,4596
2355,1766,4121,89,62,151,4,4597
93,45,138,3,1,4,4,4598
22,50,72,1,3,4,4,4599
4,12,16,0,0,0,4,4600
2,1,3,0,0,0,4,4601
1,0,1,0,0,0,4,4602
12,4,16,0,0,0,4,4603
5,8,13,0,0,0,4,4604
2,0,2,0,0,0,4,4605
1,2,3,0,0,0,4,4606
2,0,2,0,0,0,4,4607
5,3,8,0,0,0,4,4608
7,2,9,0,0,0,4,4609
2,2,4,0,0,0,4,4610
2,0,2,0,0,0,4,4611
0,1,1,0,0,0,4,4612
0,2,2,0,0,0,4,4613
24,7,31,2,1,3,4,4614
7,2,9,0,0,0,4,4615
0,1,1,0,0,0,4,4616
2,2,4,0,0,0,4,4617
0,0,0,0,0,0,4,4618
1,1,2,0,0,0,4,4619
3,11,14,0,0,0,4,4620
3,12,15,1,1,2,4,4621
3,16,19,0,5,5,4,4622
17,65,82,0,4,4,4,4623
1,0,1,0,0,0,4,4624
3,4,7,0,0,0,4,4625
2,6,8,0,0,0,4,4626
1,3,4,0,0,0,4,4627
34,46,80,1,3,4,4,4628
6,0,6,0,0,0,4,4629
7,6,13,0,0,0,4,4630
2,0,2,0,0,0,4,4631
2,0,2,0,0,0,4,4632
1,0,1,0,0,0,4,4633
17,22,39,0,0,0,4,4634
28,67,95,2,3,5,4,4635
1,0,1,0,0,0,4,4636
2,8,10,0,0,0,4,4637
0,3,3,0,0,0,4,4638
3,16,19,0,0,0,4,4639
9,12,21,1,0,1,4,4640
8,8,16,1,0,1,4,4641
0,0,0,0,0,0,4,4642
0,4,4,0,0,0,4,4643
0,0,0,0,0,0,4,4644
0,1,1,0,0,0,4,4645
0,0,0,0,0,0,4,4646
1,0,1,0,0,0,4,4647
6,3,9,0,0,0,4,4648
5,12,17,0,0,0,4,4649
2,0,2,0,0,0,4,4650
2,5,7,0,1,1,4,4651
5,34,39,0,4,4,4,4652
1,1,2,0,0,0,4,4653
1,0,1,0,0,0,4,4654
0,1,1,0,0,0,4,4655
0,0,0,0,0,0,4,4656
94,266,360,1,8,9,4,4657
0,1,1,0,0,0,4,4658
4,4,8,1,0,1,4,4659
2,2,4,0,0,0,4,4660
3,0,3,0,0,0,4,4661
0,2,2,0,0,0,4,4662
4,8,12,0,2,2,4,4663
17,125,142,0,0,0,4,4664
3,1,4,0,0,0,4,4665
147,51,198,5,5,10,4,4666
102,104,206,1,6,7,4,4667
1,4,5,0,0,0,4,4668
0,1,1,0,1,1,4,4669
8,25,33,1,0,1,4,4670
32,11,43,1,1,2,4,4671
0,4,4,0,0,0,4,4672
0,0,0,0,0,0,4,4673
20,1,21,16,1,17,4,4674
0,0,0,0,0,0,4,4675
2,2,4,0,0,0,4,4676
0,0,0,0,0,0,4,4677
0,0,0,0,0,0,4,4678
0,0,0,0,0,0,4,4679
1,2,3,0,0,0,4,4680
1,0,1,0,0,0,4,4681
2,0,2,0,0,0,4,4682
0,0,0,0,0,0,4,4683
0,0,0,0,0,0,4,4684
131,181,312,1,2,3,4,4685
195,184,379,0,3,3,4,4686
36,12,48,3,1,4,4,4687
2,6,8,1,0,1,4,4688
1,0,1,0,0,0,4,4689
4,1,5,0,0,0,4,4690
3,5,8,1,0,1,4,4691
1,0,1,0,0,0,4,4692
12,30,42,1,0,1,4,4693
1,0,1,0,0,0,4,4694
0,0,0,0,0,0,4,4695
0,0,0,0,0,0,4,4696
4,5,9,0,0,0,4,4697
3,0,3,0,0,0,4,4698
3,0,3,0,0,0,4,4699
6,4,10,0,0,0,4,4700
10,12,22,0,0,0,4,4701
7,2,9,0,0,0,4,4702
1,0,1,0,0,0,4,4703
0,0,0,0,0,0,4,4704
92,114,206,3,4,7,4,4705
2,8,10,0,1,1,4,4706
8,1,9,0,0,0,4,4707
0,0,0,0,0,0,4,4708
3,1,4,0,0,0,4,4709
3,20,23,0,1,1,4,4710
3,0,3,0,0,0,4,4711
1,0,1,0,0,0,4,4712
3,1,4,0,0,0,4,4713
0,0,0,0,0,0,4,4714
1,2,3,0,0,0,4,4715
21,29,50,5,4,9,4,4716
2,0,2,0,0,0,4,4717
3,0,3,0,0,0,4,4718
0,0,0,0,0,0,4,4719
0,0,0,0,0,0,4,4720
0,0,0,0,0,0,4,4721
5,2,7,1,0,1,4,4722
3,0,3,0,0,0,4,4723
0,0,0,0,0,0,4,4724
0,0,0,0,0,0,4,4725
0,1,1,0,0,0,4,4726
0,0,0,0,0,0,4,4727
2,5,7,0,1,1,4,4728
1,0,1,0,0,0,4,4729
0,0,0,0,0,0,4,4730
0,0,0,0,0,0,4,4731
0,0,0,0,0,0,4,4732
0,0,0,0,0,0,4,4733
0,0,0,0,0,0,4,4734
0,0,0,0,0,0,4,4735
2,1,3,0,0,0,4,4736
2,1,3,1,0,1,4,4737
0,0,0,0,0,0,4,4738
1,0,1,0,0,0,4,4739
0,0,0,0,0,0,4,4740
1,2,3,0,0,0,4,4741
0,0,0,0,0,0,4,4742
0,0,0,0,0,0,4,4743
0,0,0,0,0,0,4,4744
1,0,1,0,0,0,4,4745
6,1,7,0,0,0,4,4746
1,1,2,0,0,0,4,4747
0,3,3,0,0,0,4,4748
1,0,1,0,0,0,4,4749
0,0,0,0,0,0,4,4750
0,0,0,0,0,0,4,4751
1,2,3,0,0,0,4,4752
0,0,0,0,0,0,4,4753
0,0,0,0,0,0,4,4754
1,0,1,0,0,0,4,4755
9,5,14,1,0,1,4,4756
0,0,0,0,0,0,4,4757
0,0,0,0,0,0,4,4758
0,0,0,0,0,0,4,4759
0,0,0,0,0,0,4,4760
1,4,5,0,0,0,4,4761
0,0,0,0,0,0,4,4762
0,0,0,0,0,0,4,4763
0,0,0,0,0,0,4,4764
1,1,2,0,0,0,4,4765
0,0,0,0,0,0,4,4766
0,0,0,0,0,0,4,4767
0,1,1,0,0,0,4,4768
0,0,0,0,0,0,4,4769
0,0,0,0,0,0,4,4770
0,0,0,0,0,0,4,4771
2,3,5,0,0,0,4,4772
0,0,0,0,0,0,4,4773
2,0,2,1,0,1,4,4774
3,0,3,1,0,1,4,4775
0,0,0,0,0,0,4,4776
0,0,0,0,0,0,4,4777
2,0,2,0,0,0,4,4778
0,0,0,0,0,0,4,4779
0,1,1,0,0,0,4,4780
1,0,1,0,0,0,4,4781
2,2,4,0,0,0,4,4782
0,0,0,0,0,0,4,4783
0,0,0,0,0,0,4,4784
0,1,1,0,0,0,4,4785
0,0,0,0,0,0,4,4786
0,0,0,0,0,0,4,4787
0,0,0,0,0,0,4,4788
0,0,0,0,0,0,4,4789
1,0,1,0,0,0,4,4790
1,2,3,0,0,0,4,4791
0,1,1,0,0,0,4,4792
2,3,5,0,0,0,4,4793
0,0,0,0,0,0,4,4794
0,0,0,0,0,0,4,4795
0,0,0,0,0,0,4,4796
1,0,1,0,0,0,4,4797
2,13,15,1,3,4,4,4798
0,0,0,0,0,0,4,4799
6,3,9,0,0,0,4,4800
0,0,0,0,0,0,4,4801
3,10,13,0,0,0,4,4802
0,1,1,0,0,0,4,4803
0,0,0,0,0,0,4,4804
2,2,4,0,0,0,4,4805
1,0,1,0,0,0,4,4806
0,0,0,0,0,0,4,4807
14,9,23,2,1,3,4,4808
26,17,43,1,3,4,4,4809
0,2,2,0,1,1,4,4810
1,8,9,1,1,2,4,4811
0,0,0,0,0,0,4,4812
1,0,1,0,0,0,4,4813
0,0,0,0,0,0,4,4814
18,2,20,0,0,0,4,4815
0,0,0,0,0,0,4,4816
54,4,58,1,2,3,4,4817
3,1,4,0,0,0,4,4818
0,0,0,0,0,0,4,4819
2,0,2,0,0,0,4,4820
2,0,2,0,0,0,4,4821
0,0,0,0,0,0,4,4822
0,0,0,0,0,0,4,4823
0,0,0,0,0,0,4,4824
4,4,8,0,1,1,4,4825
8,7,15,1,0,1,4,4826
3,2,5,1,0,1,4,4827
0,0,0,0,0,0,4,4828
0,0,0,0,0,0,4,4829
358,224,582,28,24,52,4,4830
1,0,1,1,0,1,4,4831
130,293,423,7,19,26,4,4832
0,0,0,0,0,0,4,4833
0,0,0,0,0,0,4,4834
1,0,1,0,0,0,4,4835
0,0,0,0,0,0,4,4836
0,0,0,0,0,0,4,4837
13,17,30,2,3,5,4,4838
8,12,20,0,0,0,4,4839
0,0,0,0,0,0,4,4840
2,1,3,0,0,0,4,4841
0,1,1,0,0,0,4,4842
1,0,1,0,0,0,4,4843
2,1,3,0,0,0,4,4844
0,0,0,0,0,0,4,4845
0,0,0,0,0,0,4,4846
0,0,0,0,0,0,4,4847
0,0,0,0,0,0,4,4848
0,0,0,0,0,0,4,4849
0,0,0,0,0,0,4,4850
0,4,4,0,2,2,4,4851
0,9,9,0,5,5,4,4852
1,0,1,0,0,0,4,4853
0,1,1,0,0,0,4,4854
0,1,1,0,0,0,4,4855
1,1,2,1,0,1,4,4856
0,0,0,0,0,0,4,4857
0,0,0,0,0,0,4,4858
2,0,2,0,0,0,4,4859
0,0,0,0,0,0,4,4860
1,0,1,1,0,1,4,4861
0,1,1,0,0,0,4,4862
0,0,0,0,0,0,4,4863
0,0,0,0,0,0,4,4864
0,1,1,0,0,0,4,4865
1,0,1,0,0,0,4,4866
1,0,1,0,0,0,4,4867
0,0,0,0,0,0,4,4868
0,0,0,0,0,0,4,4869
0,0,0,0,0,0,4,4870
0,0,0,0,0,0,4,4871
0,0,0,0,0,0,4,4872
1,0,1,0,0,0,4,4873
0,0,0,0,0,0,4,4874
3,0,3,0,0,0,4,4875
0,0,0,0,0,0,4,4876
0,0,0,0,0,0,4,4877
0,0,0,0,0,0,4,4878
8,4,12,0,1,1,4,4879
2,6,8,2,2,4,4,4880
0,3,3,0,1,1,4,4881
2,0,2,0,0,0,4,4882
10,28,38,1,5,6,4,4883
0,0,0,0,0,0,4,4884
0,1,1,0,0,0,4,4885
5,3,8,5,3,8,4,4886
3,2,5,1,2,3,4,4887
1,0,1,1,0,1,4,4888
0,0,0,0,0,0,4,4889
0,0,0,0,0,0,4,4890
1,0,1,0,0,0,4,4891
0,0,0,0,0,0,4,4892
0,0,0,0,0,0,4,4893
0,0,0,0,0,0,4,4894
0,0,0,0,0,0,4,4895
0,0,0,0,0,0,4,4896
4,1,5,2,0,2,4,4897
0,0,0,0,0,0,4,4898
0,6,6,0,4,4,4,4899
0,0,0,0,0,0,4,4900
1,0,1,0,0,0,4,4901
5,8,13,1,1,2,4,4902
4,7,11,0,2,2,4,4903
2,0,2,0,0,0,4,4904
1,0,1,0,0,0,4,4905
0,0,0,0,0,0,4,4906
3,4,7,1,2,3,4,4907
0,0,0,0,0,0,4,4908
2,1,3,0,0,0,4,4909
2,2,4,1,0,1,4,4910
1,1,2,0,0,0,4,4911
4,1,5,1,0,1,4,4912
0,1,1,0,0,0,4,4913
0,0,0,0,0,0,4,4914
0,0,0,0,0,0,4,4915
0,0,0,0,0,0,4,4916
0,0,0,0,0,0,4,4917
0,0,0,0,0,0,4,4918
0,0,0,0,0,0,4,4919
0,0,0,0,0,0,4,4920
0,0,0,0,0,0,4,4921
0,0,0,0,0,0,4,4922
7,2,9,2,0,2,4,4923
1,0,1,0,0,0,4,4924
0,1,1,0,0,0,4,4925
0,0,0,0,0,0,4,4926
0,0,0,0,0,0,4,4927
2,1,3,2,1,3,4,4928
0,0,0,0,0,0,4,4929
0,0,0,0,0,0,4,4930
0,0,0,0,0,0,4,4931
0,0,0,0,0,0,4,4932
0,0,0,0,0,0,4,4933
0,0,0,0,0,0,4,4934
0,0,0,0,0,0,4,4935
0,0,0,0,0,0,4,4936
0,0,0,0,0,0,4,4937
0,0,0,0,0,0,4,4938
0,0,0,0,0,0,4,4939
0,0,0,0,0,0,4,4940
0,0,0,0,0,0,4,4941
0,0,0,0,0,0,4,4942
0,0,0,0,0,0,4,4943
0,0,0,0,0,0,4,4944
0,0,0,0,0,0,4,4945
0,0,0,0,0,0,4,4946
2,0,2,1,0,1,4,4947
